 totalejemplos 6246
 total INF 3988
 total NAV 2258
 total RES 4239

 distance distManhattanINF 5615.1808983194705
 distance distManhattanNAV 3722.160566509291
 distance distManhattanRES 5615.181149071727
 
 pharmacy, 	NAV 
 jeb, 	NAV 
 plastic, 	INF 
 champions, 	INF 
 religion, 	NAV 
 celebrity, 	INF 
 fuck, 	NAV 
 florida, 	NAV 
 event, 	NAV 
 oprahs, 	NAV 
 advanced, 	INF 
 joke, 	NAV 
 dual-screen, 	NAV 
 hanover, 	INF 
 wbig, 	INF 
 generation, 	INF 
 brigade, 	INF 
 copycat, 	INF 
 portland, 	NAV 
 &, 	NAV 
 jakson, 	NAV 
 midwest, 	NAV 
 pinto, 	INF 
 newport, 	INF 
 theater, 	NAV 
 lableless, 	NAV 
 sunglasses, 	INF 
 evolution, 	NAV 
 -, 	NAV 
 3, 	NAV 
 elgood, 	NAV 
 2, 	NAV 
 soundtrack, 	INF 
 1, 	INF 
 corrective, 	INF 
 middleboro, 	NAV 
 7, 	INF 
 flatrock, 	NAV 
 monmouth, 	NAV 
 6, 	INF 
 5, 	NAV 
 4, 	INF 
 cafe, 	INF 
 asses, 	INF 
 9, 	INF 
 viewing, 	INF 
 angers, 	NAV 
 blower, 	NAV 
 4lug, 	NAV 
 peliculas, 	INF 
 rev, 	INF 
 truck, 	NAV 
 john, 	NAV 
 greg, 	NAV 
 mathematics, 	NAV 
 augustine, 	INF 
 drawing, 	NAV 
 relief, 	NAV 
 seattle, 	INF 
 guard, 	INF 
 lyrics-, 	INF 
 1848, 	NAV 
 f, 	NAV 
 g, 	NAV 
 myrtle, 	NAV 
 tone, 	INF 
 d, 	INF 
 e, 	NAV 
 b, 	NAV 
 shania, 	INF 
 illegal, 	NAV 
 c, 	INF 
 a, 	NAV 
 n, 	NAV 
 o, 	NAV 
 gardens, 	INF 
 l, 	NAV 
 steamportland, 	INF 
 m, 	INF 
 cutting, 	NAV 
 j, 	NAV 
 k, 	INF 
 h, 	NAV 
 i, 	NAV 
 w, 	NAV 
 v, 	NAV 
 licensing, 	INF 
 analyze, 	INF 
 u, 	NAV 
 rec, 	INF 
 t, 	NAV 
 red, 	INF 
 s, 	NAV 
 days, 	NAV 
 r, 	INF 
 smiley, 	INF 
 library, 	NAV 
 medieval, 	NAV 
 z, 	INF 
 zone, 	NAV 
 y, 	INF 
 x, 	NAV 
 resources, 	NAV 
 endometrial, 	NAV 
 forbes, 	NAV 
 cabo, 	NAV 
 dylan, 	INF 
 infant, 	INF 
 tool, 	NAV 
 architecture, 	NAV 
 policies, 	NAV 
 michaels, 	INF 
 description, 	INF 
 plaster, 	INF 
 smallville, 	NAV 
 jam, 	INF 
 motion, 	NAV 
 marquee, 	NAV 
 station, 	INF 
 carpeted, 	INF 
 leisure, 	NAV 
 jay, 	NAV 
 double, 	NAV 
 mississippi, 	NAV 
 loveland, 	INF 
 country, 	NAV 
 marques, 	INF 
 canine, 	INF 
 testimonies, 	INF 
 jbl, 	NAV 
 ashland, 	INF 
 brass, 	NAV 
 spam, 	INF 
 anime, 	NAV 
 pittman, 	INF 
 update, 	NAV 
 raw, 	INF 
 cannoli, 	NAV 
 prophet, 	NAV 
 ray, 	NAV 
 pawleys, 	NAV 
 horse, 	INF 
 horry, 	NAV 
 derry, 	INF 
 edgewater, 	NAV 
 pinot, 	NAV 
 business, 	NAV 
 twin, 	INF 
 johnsonsmith, 	INF 
 dime, 	INF 
 hilton's, 	INF 
 wicker, 	INF 
 quantum, 	NAV 
 hamiliton, 	NAV 
 hatteras, 	INF 
 treasure, 	INF 
 immigration, 	NAV 
 andrea, 	INF 
 axim, 	INF 
 fuel, 	INF 
 neilson, 	INF 
 dickenson, 	INF 
 chris, 	NAV 
 updates, 	NAV 
 declaw, 	INF 
 hospitals, 	NAV 
 hello, 	NAV 
 ding, 	INF 
 convoy, 	INF 
 entire, 	NAV 
 wooden, 	NAV 
 which, 	NAV 
 amusement, 	NAV 
 female, 	NAV 
 royal, 	INF 
 vaca, 	INF 
 stratford, 	INF 
 sunrise, 	INF 
 nursing, 	NAV 
 lowes, 	NAV 
 durham, 	INF 
 jobs, 	NAV 
 chubby, 	INF 
 liability, 	INF 
 amateur, 	INF 
 rock, 	NAV 
 cuttings, 	INF 
 help, 	NAV 
 vans, 	INF 
 wholesale, 	NAV 
 bones, 	NAV 
 hampton, 	NAV 
 20community, 	NAV 
 huntingdon, 	INF 
 indigo, 	NAV 
 odor, 	INF 
 spanish, 	NAV 
 support, 	NAV 
 mens, 	NAV 
 ron, 	INF 
 identify, 	INF 
 menu, 	NAV 
 quiksilver, 	INF 
 puerto, 	NAV 
 job, 	NAV 
 health, 	NAV 
 hamburger, 	NAV 
 shoulders, 	INF 
 altournative, 	INF 
 dentistry, 	INF 
 offender, 	NAV 
 tango, 	NAV 
 avenue, 	NAV 
 branch, 	NAV 
 medicare, 	NAV 
 wifes, 	INF 
 western, 	INF 
 6010, 	INF 
 allergy, 	INF 
 tennesse, 	NAV 
 uniforms, 	INF 
 purim, 	INF 
 television, 	NAV 
 technician, 	NAV 
 shawn, 	NAV 
 vehicle, 	INF 
 counties, 	INF 
 thought, 	INF 
 road, 	NAV 
 alameda, 	INF 
 express, 	NAV 
 space, 	NAV 
 joe, 	NAV 
 boys, 	INF 
 mavericks, 	INF 
 cypress, 	INF 
 construction, 	NAV 
 marketing, 	NAV 
 taipei, 	INF 
 suggestions, 	INF 
 psychologist, 	NAV 
 dialated, 	INF 
 jr., 	INF 
 telephone, 	NAV 
 manufacturing, 	NAV 
 single, 	NAV 
 hebrew, 	NAV 
 freer, 	NAV 
 pierre, 	INF 
 calorie, 	INF 
 pozzo, 	INF 
 disc, 	INF 
 python, 	NAV 
 jim, 	INF 
 anita, 	INF 
 muscles, 	NAV 
 pray, 	NAV 
 dirt, 	NAV 
 mcafee, 	NAV 
 mesh, 	INF 
 reviews, 	NAV 
 painted, 	NAV 
 504, 	INF 
 mcgee, 	NAV 
 embedded, 	INF 
 chevy, 	NAV 
 theatre, 	NAV 
 vain, 	INF 
 surveys, 	NAV 
 polish, 	INF 
 phila, 	INF 
 coral, 	INF 
 belarus, 	INF 
 chest, 	NAV 
 security, 	NAV 
 disease, 	NAV 
 80th, 	INF 
 while, 	INF 
 townhall.com, 	INF 
 super, 	INF 
 ignatius, 	NAV 
 beaded, 	NAV 
 drum, 	NAV 
 stephen, 	INF 
 gifted, 	INF 
 drug, 	NAV 
 poker, 	INF 
 troubleshooting, 	NAV 
 burberry, 	INF 
 1879, 	INF 
 derick, 	INF 
 indian, 	NAV 
 dodge, 	NAV 
 offer, 	INF 
 amazon, 	NAV 
 1880, 	INF 
 keelhaulers, 	NAV 
 naked, 	INF 
 advance, 	NAV 
 sugar, 	INF 
 flop, 	NAV 
 fresno, 	NAV 
 discussion, 	INF 
 itr, 	NAV 
 clinic, 	NAV 
 halloween, 	NAV 
 sayings, 	INF 
 arena, 	INF 
 phylogenetic, 	NAV 
 potter, 	NAV 
 drink, 	INF 
 eset, 	INF 
 signs, 	INF 
 cheat, 	NAV 
 charter, 	INF 
 republican, 	NAV 
 pied, 	INF 
 miami, 	NAV 
 under, 	NAV 
 soul, 	INF 
 libe, 	INF 
 calls, 	INF 
 warren, 	INF 
 florist, 	NAV 
 system, 	NAV 
 prek, 	INF 
 kasabuski, 	NAV 
 favor, 	NAV 
 cheak, 	INF 
 palatka, 	INF 
 charlie, 	INF 
 cheap, 	INF 
 whitethorn, 	NAV 
 buddy, 	INF 
 patrol, 	NAV 
 tournament, 	INF 
 monolingual, 	INF 
 press, 	INF 
 patron, 	NAV 
 oklahoma, 	NAV 
 poses, 	NAV 
 eviction, 	NAV 
 ivy, 	NAV 
 charles, 	INF 
 avn7000, 	INF 
 odds, 	NAV 
 laundry, 	NAV 
 rum, 	INF 
 iron, 	INF 
 graduation, 	NAV 
 trojan, 	INF 
 pics, 	NAV 
 life, 	NAV 
 truth, 	NAV 
 graduate, 	NAV 
 worker, 	NAV 
 reloading, 	INF 
 mets, 	NAV 
 brinkman, 	INF 
 yahoo, 	NAV 
 consulting, 	INF 
 rates, 	INF 
 o'hara's, 	INF 
 printer, 	INF 
 works, 	INF 
 michigan, 	NAV 
 facial, 	NAV 
 rx8, 	INF 
 rated, 	INF 
 world, 	NAV 
 montessori, 	NAV 
 elementary, 	NAV 
 cara, 	NAV 
 carb, 	NAV 
 thicker, 	INF 
 must, 	INF 
 removal, 	INF 
 friends, 	NAV 
 cars, 	INF 
 care, 	NAV 
 card, 	INF 
 nitrous, 	INF 
 conover, 	INF 
 20church, 	NAV 
 vita, 	INF 
 nigris, 	INF 
 prix, 	INF 
 eminem, 	NAV 
 cart, 	NAV 
 cary, 	NAV 
 tourist, 	INF 
 cast, 	INF 
 inflatable, 	INF 
 augusta, 	NAV 
 case, 	NAV 
 teacher, 	NAV 
 song, 	NAV 
 walking, 	NAV 
 irs, 	NAV 
 cheapest, 	INF 
 aero, 	INF 
 mandinka, 	NAV 
 lakes, 	NAV 
 swimming, 	INF 
 cats, 	NAV 
 migraine, 	NAV 
 levon, 	NAV 
 vadhan, 	INF 
 drill, 	NAV 
 vash, 	INF 
 mercy, 	NAV 
 ripper, 	INF 
 wrestling, 	INF 
 soon, 	NAV 
 player's, 	INF 
 sony, 	INF 
 catholic, 	NAV 
 seven, 	NAV 
 breads, 	INF 
 watermelon, 	INF 
 universities, 	INF 
 rrr, 	NAV 
 giant, 	NAV 
 birth, 	INF 
 eurogroup, 	INF 
 sad, 	INF 
 swamper, 	INF 
 everything, 	NAV 
 paulding, 	INF 
 critchfield, 	INF 
 stanford, 	NAV 
 sam, 	INF 
 ridge, 	INF 
 camp, 	NAV 
 stock, 	INF 
 stripping, 	NAV 
 solo, 	NAV 
 can't, 	NAV 
 drive, 	NAV 
 morgan, 	NAV 
 fuji, 	INF 
 pink, 	INF 
 yourself, 	NAV 
 bilateral, 	NAV 
 ping, 	NAV 
 grove, 	NAV 
 sold, 	NAV 
 pima, 	INF 
 jose, 	NAV 
 josh, 	NAV 
 like, 	NAV 
 grieving, 	NAV 
 chromosomes, 	INF 
 san, 	NAV 
 williamson, 	INF 
 soma, 	NAV 
 years, 	NAV 
 7556, 	NAV 
 dance, 	INF 
 some, 	NAV 
 culture, 	NAV 
 cityof, 	INF 
 oceanfront, 	INF 
 altace, 	INF 
 christi, 	INF 
 textbooks, 	INF 
 scarlet, 	INF 
 cape, 	NAV 
 hiapo, 	NAV 
 spartanburg, 	NAV 
 words, 	NAV 
 ohio, 	NAV 
 buying, 	INF 
 calci, 	INF 
 fighter, 	NAV 
 flip, 	NAV 
 pron, 	INF 
 prom, 	NAV 
 nassau, 	NAV 
 ringtones, 	INF 
 verbal, 	NAV 
 broken, 	INF 
 fixing, 	NAV 
 hallock, 	NAV 
 corned, 	INF 
 tacoma, 	INF 
 westminster, 	INF 
 brunette, 	INF 
 beacon, 	INF 
 bowling, 	NAV 
 tour, 	INF 
 broker, 	INF 
 p5nd2, 	INF 
 purse, 	NAV 
 casinos, 	NAV 
 elton, 	INF 
 airboats, 	INF 
 finishing, 	NAV 
 function, 	NAV 
 police, 	NAV 
 etiquette, 	NAV 
 potawatomi, 	INF 
 fund, 	INF 
 head, 	NAV 
 robert, 	NAV 
 hilton, 	NAV 
 cake, 	INF 
 celtic, 	INF 
 visitors, 	INF 
 immunizations, 	NAV 
 offenders, 	INF 
 hemet, 	INF 
 sheraton, 	INF 
 tullys, 	INF 
 lift, 	INF 
 town, 	NAV 
 characters, 	INF 
 dissolve, 	NAV 
 soil, 	NAV 
 pines, 	INF 
 watercolor, 	INF 
 call, 	NAV 
 gwinnett, 	INF 
 20is, 	NAV 
 hyper, 	NAV 
 paper, 	NAV 
 hacer, 	NAV 
 burton, 	NAV 
 virus, 	NAV 
 pipe, 	INF 
 eclipse, 	NAV 
 hanging, 	NAV 
 officers, 	NAV 
 rider, 	NAV 
 39th, 	INF 
 parker, 	INF 
 rides, 	INF 
 raymond, 	INF 
 full, 	NAV 
 glass, 	NAV 
 making, 	NAV 
 students, 	NAV 
 catalytic, 	INF 
 check, 	INF 
 awol, 	INF 
 jeans, 	NAV 
 century, 	INF 
 sanford, 	INF 
 soft, 	NAV 
 tejas, 	INF 
 autocad, 	INF 
 dred, 	NAV 
 toys, 	NAV 
 pastry, 	INF 
 savol, 	INF 
 minerals, 	NAV 
 average, 	INF 
 4-h, 	NAV 
 jimmy, 	NAV 
 freedom, 	INF 
 mellot, 	NAV 
 kim, 	NAV 
 visit, 	NAV 
 kia, 	NAV 
 lynn, 	NAV 
 becoming, 	INF 
 she, 	RES 
 jerez, 	NAV 
 slippery, 	NAV 
 sears, 	INF 
 something, 	INF 
 yevonne, 	INF 
 pussy, 	NAV 
 black, 	NAV 
 anbu, 	INF 
 florida-, 	NAV 
 saline, 	INF 
 moving, 	INF 
 death, 	INF 
 convention, 	NAV 
 continental, 	NAV 
 carteret, 	INF 
 snakes, 	INF 
 neverland, 	NAV 
 cities, 	NAV 
 farnsworth, 	NAV 
 groomsman, 	NAV 
 timothy, 	NAV 
 400, 	NAV 
 owners, 	NAV 
 needlepoint, 	NAV 
 wedel's, 	INF 
 boca, 	INF 
 iron-away, 	NAV 
 ocean, 	INF 
 allegheny, 	INF 
 seeking, 	INF 
 six, 	RES 
 pancake, 	INF 
 allstate, 	INF 
 suny, 	INF 
 allergic, 	INF 
 smoking, 	NAV 
 stmary, 	NAV 
 antioch, 	INF 
 plains, 	NAV 
 france, 	INF 
 414, 	INF 
 customs, 	NAV 
 pinball, 	INF 
 2nd, 	INF 
 rihanna, 	NAV 
 embassy, 	INF 
 verizon, 	INF 
 traditional, 	NAV 
 boat, 	INF 
 soda, 	INF 
 shu, 	INF 
 history, 	NAV 
 wilderness, 	INF 
 sin, 	INF 
 background, 	INF 
 hannah, 	NAV 
 conceive, 	INF 
 anal, 	INF 
 bound, 	INF 
 topper, 	INF 
 body, 	NAV 
 blacks, 	NAV 
 impossible, 	NAV 
 salsa, 	INF 
 cleveland, 	NAV 
 lullabye, 	INF 
 butte, 	INF 
 reaching, 	NAV 
 myeloid, 	INF 
 baric, 	NAV 
 paying, 	NAV 
 light, 	NAV 
 key, 	INF 
 ages, 	INF 
 eagel, 	INF 
 airboat, 	INF 
 northgate, 	NAV 
 roddick, 	INF 
 insulin, 	NAV 
 german, 	NAV 
 meyers, 	NAV 
 script, 	NAV 
 agent, 	NAV 
 executive, 	NAV 
 oral, 	NAV 
 saddle, 	INF 
 better, 	INF 
 against, 	NAV 
 bible, 	NAV 
 walk, 	INF 
 wall, 	NAV 
 sex, 	NAV 
 saying, 	INF 
 portopalo, 	INF 
 vice, 	INF 
 department, 	NAV 
 set, 	INF 
 sfa, 	INF 
 a&m, 	NAV 
 enhance, 	INF 
 tiles, 	INF 
 kci, 	NAV 
 wake, 	INF 
 alpha, 	INF 
 vida, 	NAV 
 communication, 	INF 
 society, 	INF 
 335i, 	INF 
 funny, 	NAV 
 sea, 	NAV 
 andy, 	INF 
 seams, 	INF 
 m&m, 	NAV 
 bridal, 	INF 
 deepak, 	INF 
 see, 	INF 
 wedding, 	NAV 
 davidson, 	NAV 
 suit, 	NAV 
 passport, 	NAV 
 visas, 	NAV 
 william, 	INF 
 enuff, 	INF 
 they, 	INF 
 sexi, 	INF 
 recipe, 	NAV 
 jigsaw, 	NAV 
 fele, 	NAV 
 m3x, 	NAV 
 spo, 	NAV 
 actor, 	NAV 
 council, 	INF 
 birds, 	INF 
 renaissance, 	INF 
 sexy, 	NAV 
 terry, 	INF 
 internship, 	INF 
 weekend, 	INF 
 buyer, 	NAV 
 rented, 	INF 
 skinned, 	INF 
 knives, 	NAV 
 auditorium, 	INF 
 spa, 	INF 
 pigeon, 	NAV 
 programs, 	NAV 
 lesson, 	NAV 
 structure, 	INF 
 amino, 	INF 
 church, 	NAV 
 soy, 	INF 
 akcija, 	NAV 
 son, 	NAV 
 steps, 	NAV 
 raccoon, 	INF 
 thinkpad, 	NAV 
 terra, 	NAV 
 sod, 	NAV 
 sculpture, 	NAV 
 russian, 	INF 
 erie, 	INF 
 them, 	INF 
 endmills, 	INF 
 eric, 	NAV 
 children's, 	INF 
 alphabet, 	INF 
 records, 	NAV 
 villanueva, 	INF 
 satellite, 	INF 
 scott, 	NAV 
 occupational, 	NAV 
 marinade, 	NAV 
 raised, 	INF 
 gospel, 	NAV 
 skank, 	INF 
 pictures, 	NAV 
 chicopee, 	NAV 
 highland, 	INF 
 hawaiian, 	NAV 
 st., 	INF 
 chapelle, 	NAV 
 striped, 	INF 
 cooking, 	INF 
 clinical, 	INF 
 fein, 	INF 
 denture, 	INF 
 cushman, 	INF 
 polar, 	INF 
 birch, 	INF 
 scout, 	INF 
 jockey, 	INF 
 bombs, 	INF 
 scholarship, 	NAV 
 prejudice, 	INF 
 stern, 	INF 
 it's, 	NAV 
 crimping, 	INF 
 sued, 	NAV 
 hunter, 	NAV 
 mckinney, 	NAV 
 triangle, 	INF 
 don's, 	INF 
 design, 	INF 
 barrs, 	INF 
 payless, 	INF 
 replacement, 	INF 
 cause, 	INF 
 second, 	NAV 
 spotting, 	NAV 
 equity, 	INF 
 adhesive, 	INF 
 taupe, 	INF 
 permit, 	NAV 
 study, 	NAV 
 chat, 	INF 
 atlanta, 	INF 
 middle, 	NAV 
 bonethugs-n-harmony, 	INF 
 obituaries, 	NAV 
 sky, 	INF 
 hardcore, 	NAV 
 centurion, 	INF 
 parish, 	INF 
 blessid, 	INF 
 camps, 	NAV 
 arctic, 	INF 
 comfortpedic, 	INF 
 ski, 	NAV 
 november, 	NAV 
 freegames, 	INF 
 chiropractic, 	NAV 
 suck, 	INF 
 offering, 	INF 
 favorites, 	INF 
 heterozygous, 	INF 
 rental, 	NAV 
 league, 	NAV 
 academy, 	INF 
 terrace, 	INF 
 ottsville, 	NAV 
 mother, 	NAV 
 chciago, 	INF 
 mattress, 	NAV 
 ibew, 	NAV 
 lamar, 	INF 
 this, 	NAV 
 release, 	INF 
 mining, 	INF 
 bamboo, 	INF 
 celsius, 	INF 
 sno, 	INF 
 gibson, 	NAV 
 decker, 	INF 
 bangor, 	INF 
 cheese, 	NAV 
 adverse, 	INF 
 online, 	NAV 
 steve, 	INF 
 real, 	NAV 
 scoop, 	INF 
 lugares, 	NAV 
 read, 	NAV 
 stevens, 	NAV 
 stuck, 	INF 
 colored, 	INF 
 stucs, 	INF 
 goddesses, 	NAV 
 huntington's, 	NAV 
 coach, 	INF 
 esteem, 	NAV 
 rear, 	INF 
 smv, 	INF 
 jeffreys, 	NAV 
 kulalani, 	NAV 
 nike, 	NAV 
 reception, 	NAV 
 missouri, 	NAV 
 pamela, 	INF 
 wrong, 	NAV 
 runner, 	INF 
 hugger, 	NAV 
 skins, 	INF 
 guide, 	NAV 
 vineyard, 	INF 
 samantha, 	INF 
 albany, 	INF 
 stickers, 	INF 
 wellesley, 	INF 
 quail, 	INF 
 lucie, 	INF 
 packaging, 	INF 
 snow, 	NAV 
 hyundai, 	INF 
 points, 	NAV 
 invitation, 	INF 
 brain, 	INF 
 chilean, 	INF 
 avalanche, 	INF 
 turn, 	INF 
 monster, 	INF 
 24, 	INF 
 dillsburg, 	NAV 
 26, 	NAV 
 27, 	INF 
 pointe, 	INF 
 bord, 	NAV 
 30, 	INF 
 49ers, 	INF 
 crime, 	NAV 
 harvard, 	NAV 
 goldeneye, 	NAV 
 shower, 	NAV 
 ways, 	INF 
 born, 	NAV 
 myspacecom, 	NAV 
 daughter, 	NAV 
 17, 	INF 
 18, 	INF 
 northwest, 	NAV 
 16, 	INF 
 13, 	NAV 
 14, 	INF 
 differences, 	INF 
 11, 	INF 
 phila., 	INF 
 21, 	INF 
 20, 	INF 
 vulcan, 	NAV 
 t-shirt, 	NAV 
 civil, 	NAV 
 seeds, 	INF 
 vermillion, 	INF 
 bragg, 	NAV 
 soccer, 	NAV 
 clarinex, 	INF 
 direct, 	INF 
 dolls, 	NAV 
 reef, 	INF 
 03, 	INF 
 combined, 	INF 
 bahama, 	INF 
 geffen, 	INF 
 10, 	NAV 
 germantown, 	INF 
 fredricksburg, 	INF 
 braless, 	INF 
 falls, 	NAV 
 bennett, 	INF 
 aaron, 	INF 
 decrease, 	NAV 
 variable, 	INF 
 salad, 	NAV 
 recording, 	INF 
 toronto, 	INF 
 album, 	NAV 
 ssa, 	INF 
 thai, 	NAV 
 prognosis, 	INF 
 exploration, 	INF 
 after, 	NAV 
 centreville, 	NAV 
 charlotte, 	INF 
 tennis, 	NAV 
 fruit, 	INF 
 alessandra, 	INF 
 69, 	INF 
 68, 	INF 
 shinedown, 	INF 
 cinemark, 	INF 
 8030b, 	INF 
 canada, 	INF 
 kelleher, 	NAV 
 association, 	NAV 
 associates, 	NAV 
 labels, 	NAV 
 white, 	NAV 
 that, 	NAV 
 th5c5, 	INF 
 practitioner, 	NAV 
 associated, 	INF 
 than, 	INF 
 races, 	NAV 
 75, 	NAV 
 westchester, 	INF 
 sub, 	NAV 
 model, 	NAV 
 about, 	NAV 
 valentine, 	INF 
 sun, 	NAV 
 ruth, 	INF 
 triboro, 	INF 
 weichert, 	INF 
 complete, 	INF 
 globetrac, 	NAV 
 companion, 	INF 
 unemployability, 	INF 
 feed, 	INF 
 severe, 	INF 
 russ, 	INF 
 accent, 	INF 
 tractor, 	INF 
 girls, 	NAV 
 duffy, 	NAV 
 44, 	NAV 
 rebuilt, 	INF 
 feet, 	NAV 
 manhattan, 	INF 
 fees, 	INF 
 recovery, 	INF 
 bling, 	INF 
 infinite, 	NAV 
 dekalb, 	INF 
 citrus, 	NAV 
 flaming, 	INF 
 grow, 	NAV 
 outdoor, 	INF 
 service, 	NAV 
 circuit, 	NAV 
 brief, 	INF 
 50, 	INF 
 damas, 	NAV 
 neworleanspolice, 	NAV 
 bring, 	NAV 
 sailor, 	INF 
 merchandising, 	INF 
 palmer, 	INF 
 ancient, 	NAV 
 criminal, 	NAV 
 colonial, 	NAV 
 weather, 	NAV 
 guild, 	INF 
 wine, 	NAV 
 wind, 	INF 
 memorial, 	NAV 
 infertility, 	NAV 
 national, 	NAV 
 movado, 	NAV 
 gisele, 	NAV 
 mortgage, 	NAV 
 director, 	INF 
 tribal, 	INF 
 mothers', 	NAV 
 ward, 	NAV 
 tax, 	NAV 
 470, 	NAV 
 nails, 	NAV 
 language, 	INF 
 botetourt, 	INF 
 snip, 	INF 
 episode, 	NAV 
 google, 	NAV 
 coconut, 	NAV 
 america, 	NAV 
 tiger, 	INF 
 comedy, 	INF 
 university-, 	NAV 
 baptist, 	INF 
 buttermilk, 	INF 
 accute, 	INF 
 motorcycles, 	NAV 
 harras, 	NAV 
 title, 	NAV 
 boston, 	NAV 
 length, 	NAV 
 rent, 	NAV 
 want, 	NAV 
 98, 	NAV 
 edge, 	INF 
 boxster, 	INF 
 grip-tite, 	NAV 
 directory, 	INF 
 igigi, 	NAV 
 brand, 	NAV 
 summit, 	NAV 
 gazebo, 	INF 
 based, 	NAV 
 audiovox, 	INF 
 paddles, 	NAV 
 clark, 	INF 
 diet, 	NAV 
 renew, 	NAV 
 'dolls, 	NAV 
 compliance, 	INF 
 educator, 	INF 
 explorer, 	NAV 
 died, 	NAV 
 marina, 	INF 
 linked, 	NAV 
 icecream, 	INF 
 custom, 	INF 
 eagle, 	NAV 
 manufactured, 	INF 
 turner, 	INF 
 class, 	INF 
 property, 	NAV 
 northern, 	NAV 
 jokes, 	NAV 
 window, 	INF 
 popular, 	INF 
 crossfade, 	INF 
 friend, 	INF 
 harbour, 	INF 
 'there, 	INF 
 foxcroft, 	NAV 
 marion, 	NAV 
 wars, 	INF 
 pretty, 	INF 
 baked, 	INF 
 monkees, 	NAV 
 coast, 	INF 
 milwaukee, 	NAV 
 during, 	NAV 
 triple, 	INF 
 dick, 	INF 
 graphics, 	INF 
 rican, 	INF 
 brake, 	NAV 
 marine, 	NAV 
 office, 	NAV 
 with, 	NAV 
 invision, 	NAV 
 latinas, 	NAV 
 vista, 	NAV 
 book, 	NAV 
 sapulpa, 	INF 
 anna, 	INF 
 juanita, 	NAV 
 anne, 	INF 
 cadet, 	INF 
 nudist, 	NAV 
 northwind, 	NAV 
 bright, 	NAV 
 desktop, 	INF 
 alecktra, 	INF 
 bacon, 	INF 
 parts, 	INF 
 awareness, 	INF 
 warehouse, 	NAV 
 party, 	NAV 
 tuscaloosa, 	NAV 
 slavas, 	INF 
 compared, 	INF 
 leakey, 	NAV 
 hungry, 	NAV 
 taxon, 	NAV 
 billy, 	NAV 
 kingwood, 	INF 
 conditions, 	NAV 
 project, 	NAV 
 bio, 	INF 
 speedball, 	NAV 
 philcollins, 	INF 
 sick, 	INF 
 big, 	NAV 
 bills, 	NAV 
 unique, 	INF 
 training, 	NAV 
 authority, 	NAV 
 bathing, 	INF 
 bls, 	INF 
 side, 	INF 
 dieffenbach, 	NAV 
 pancakes, 	INF 
 tell, 	INF 
 interesting, 	NAV 
 dating, 	NAV 
 weimeraner, 	INF 
 sicily, 	INF 
 chamber, 	NAV 
 christina, 	INF 
 marriages, 	NAV 
 kawasakii, 	NAV 
 razor, 	NAV 
 latifolia, 	NAV 
 manners, 	NAV 
 electronic, 	NAV 
 genessee, 	NAV 
 testing, 	NAV 
 tiffany, 	INF 
 excelsior, 	INF 
 uric, 	INF 
 shooting, 	INF 
 ham, 	INF 
 physical, 	NAV 
 congress, 	NAV 
 bnai, 	INF 
 bob, 	INF 
 tractors, 	NAV 
 hammonton, 	INF 
 bikini, 	INF 
 cruise, 	NAV 
 has, 	NAV 
 planet, 	NAV 
 gallaghers, 	INF 
 wanting, 	NAV 
 lazarillo, 	NAV 
 commons, 	INF 
 trimming, 	NAV 
 friday, 	NAV 
 thickening, 	NAV 
 had, 	NAV 
 salveo, 	INF 
 hpinkjet, 	INF 
 302, 	INF 
 washtenaw, 	INF 
 imelda, 	NAV 
 hypoinflated, 	NAV 
 tremper, 	INF 
 georgia, 	NAV 
 rivers, 	INF 
 maple, 	NAV 
 sign, 	NAV 
 pittsburgh, 	NAV 
 patriotic, 	INF 
 hay, 	INF 
 marqiuse, 	NAV 
 pcb, 	INF 
 detencion, 	NAV 
 bmw, 	INF 
 dpfe, 	NAV 
 talks, 	NAV 
 philippines, 	NAV 
 religious, 	INF 
 flyfishing, 	NAV 
 carlson, 	INF 
 he4, 	NAV 
 packard, 	NAV 
 landforms, 	INF 
 bankhead, 	INF 
 pulse, 	INF 
 analysis, 	NAV 
 pat, 	NAV 
 great-west, 	NAV 
 silica, 	NAV 
 sussex, 	INF 
 pilot, 	NAV 
 name, 	INF 
 tasting, 	INF 
 infection, 	NAV 
 pay, 	NAV 
 tonight, 	INF 
 noggin, 	INF 
 linden, 	INF 
 hawaii, 	INF 
 rubicon, 	INF 
 sites, 	NAV 
 music, 	NAV 
 3.0, 	INF 
 chopper, 	NAV 
 tracks, 	NAV 
 vacations, 	NAV 
 salvia, 	INF 
 forge, 	NAV 
 lubricant, 	INF 
 never, 	NAV 
 there, 	RES 
 bernadette's, 	INF 
 box, 	INF 
 statuary, 	INF 
 bow, 	INF 
 dillards, 	INF 
 boy, 	INF 
 tubing, 	INF 
 limestone, 	NAV 
 calcium, 	INF 
 alchohol, 	INF 
 camron, 	INF 
 moccasin, 	NAV 
 pre-teen, 	INF 
 ephedra, 	NAV 
 bumpers, 	NAV 
 sensor, 	NAV 
 retirement, 	NAV 
 minnesota, 	NAV 
 lance, 	NAV 
 php, 	INF 
 playstation, 	INF 
 frontera, 	NAV 
 bbw, 	INF 
 doctors, 	NAV 
 her, 	NAV 
 ccharmed, 	INF 
 blown, 	INF 
 backyard, 	NAV 
 hep, 	NAV 
 bbs, 	INF 
 final, 	INF 
 transfer, 	NAV 
 nokia, 	INF 
 teen, 	NAV 
 pediatric, 	NAV 
 mexican, 	NAV 
 canyon, 	NAV 
 tonya, 	INF 
 dixon, 	INF 
 bad, 	NAV 
 carman, 	NAV 
 damages, 	NAV 
 presley, 	INF 
 bay, 	NAV 
 water-based, 	INF 
 albums, 	INF 
 performer, 	INF 
 bat, 	NAV 
 celebs, 	INF 
 bundchen, 	NAV 
 bar, 	INF 
 motherboard, 	NAV 
 gratis, 	NAV 
 foam, 	NAV 
 newspaper, 	NAV 
 columbia, 	INF 
 pew, 	INF 
 kings, 	NAV 
 fairview, 	NAV 
 jessica-, 	NAV 
 cruel, 	INF 
 fullerton, 	INF 
 unless, 	NAV 
 butt, 	INF 
 scarfs, 	NAV 
 egcg's, 	NAV 
 products, 	INF 
 listen, 	NAV 
 airline, 	INF 
 1641, 	INF 
 louis, 	NAV 
 stay, 	NAV 
 beautiful, 	INF 
 star, 	NAV 
 gopherus, 	NAV 
 archbishop, 	INF 
 lottery, 	NAV 
 speakers, 	INF 
 tech, 	NAV 
 flowtech, 	NAV 
 i-551, 	NAV 
 biracial, 	INF 
 pet, 	INF 
 force, 	NAV 
 fishing, 	NAV 
 kenyon, 	NAV 
 interior, 	NAV 
 areflexic, 	INF 
 granny's, 	NAV 
 hip, 	NAV 
 authorization, 	INF 
 calvert, 	INF 
 since, 	NAV 
 helmet, 	INF 
 smokie, 	INF 
 cooler, 	INF 
 his, 	INF 
 hit, 	NAV 
 mickey, 	NAV 
 primary, 	NAV 
 fusion, 	INF 
 craigslist, 	INF 
 roberts-the, 	NAV 
 portrayal, 	INF 
 rutland, 	INF 
 medicine, 	INF 
 prepaid, 	NAV 
 onto, 	INF 
 bonneville, 	INF 
 bee, 	INF 
 bed, 	INF 
 locking, 	NAV 
 performax, 	INF 
 team, 	NAV 
 ben, 	NAV 
 dinner, 	NAV 
 willeys, 	INF 
 paul, 	INF 
 bet, 	INF 
 installing, 	NAV 
 hybrid, 	INF 
 huntington, 	NAV 
 christian, 	INF 
 african, 	NAV 
 grease, 	NAV 
 cincinnati, 	INF 
 bruiser, 	INF 
 roger, 	INF 
 roller, 	NAV 
 incontinence, 	INF 
 addiction, 	INF 
 sweatshirts, 	INF 
 east, 	NAV 
 sandra, 	INF 
 vacuum, 	NAV 
 revenue, 	NAV 
 zip, 	INF 
 investments, 	NAV 
 annual, 	INF 
 your, 	NAV 
 colorado, 	NAV 
 play, 	INF 
 sport, 	NAV 
 francisco, 	INF 
 condemned, 	INF 
 roundtop, 	INF 
 pig, 	INF 
 mormon, 	NAV 
 paso, 	INF 
 election, 	NAV 
 earl, 	NAV 
 football, 	NAV 
 plan, 	NAV 
 pin, 	INF 
 night, 	NAV 
 navy, 	NAV 
 pit, 	INF 
 folgers, 	NAV 
 earn, 	NAV 
 evergreen, 	INF 
 step, 	NAV 
 energy, 	NAV 
 kicking, 	NAV 
 grandfather, 	NAV 
 pop, 	INF 
 customer, 	INF 
 meter, 	NAV 
 gaye, 	NAV 
 gonna, 	INF 
 plainville, 	NAV 
 kenmore, 	NAV 
 cosplay, 	INF 
 cardinal, 	INF 
 plans-, 	NAV 
 heads, 	NAV 
 churches, 	INF 
 mayors, 	INF 
 goodnight, 	NAV 
 blood, 	INF 
 temple, 	INF 
 savannah, 	INF 
 nick, 	NAV 
 nesting, 	INF 
 macaroni, 	NAV 
 juelz, 	INF 
 ppd, 	NAV 
 appraisal, 	INF 
 god, 	NAV 
 wildlife, 	NAV 
 respiratory, 	NAV 
 surfing, 	NAV 
 tycoon, 	INF 
 american, 	NAV 
 dresses, 	NAV 
 best, 	NAV 
 golf, 	NAV 
 gold, 	NAV 
 ambrosio, 	INF 
 canister, 	INF 
 turbo, 	INF 
 site, 	NAV 
 whatever, 	INF 
 statler, 	INF 
 mariann, 	NAV 
 bull, 	INF 
 bulk, 	INF 
 sheetmusic, 	INF 
 wrinkle, 	NAV 
 bule, 	NAV 
 gave, 	NAV 
 dietary, 	INF 
 bulb, 	INF 
 lumber, 	INF 
 norwood, 	NAV 
 hills, 	NAV 
 lo-max, 	INF 
 splash, 	NAV 
 colbert, 	INF 
 bust, 	NAV 
 bend, 	NAV 
 good, 	NAV 
 remix, 	INF 
 doug, 	NAV 
 botanical, 	NAV 
 benh, 	INF 
 metal, 	NAV 
 bush, 	INF 
 humana, 	INF 
 leather, 	NAV 
 psp, 	INF 
 connells, 	INF 
 control, 	INF 
 preserves, 	NAV 
 electric, 	NAV 
 fecal, 	NAV 
 pub, 	INF 
 difiant, 	INF 
 boating, 	NAV 
 bell, 	NAV 
 chocolates, 	INF 
 awards, 	INF 
 belt, 	INF 
 burn, 	INF 
 got, 	NAV 
 cultivating, 	INF 
 gov, 	NAV 
 car, 	NAV 
 fisheries, 	NAV 
 rollercoaster, 	INF 
 cat, 	NAV 
 gsa, 	INF 
 can, 	NAV 
 canoe, 	NAV 
 children, 	NAV 
 sissy, 	INF 
 canoa, 	INF 
 blogs, 	INF 
 porcentaje, 	NAV 
 swiss, 	INF 
 cab, 	INF 
 collector, 	NAV 
 surfer, 	INF 
 fisting, 	INF 
 blackbeard, 	INF 
 geopgraphy, 	NAV 
 orchard, 	INF 
 extended, 	NAV 
 juegosfree, 	NAV 
 psa, 	INF 
 you, 	NAV 
 korean, 	INF 
 suleyman, 	INF 
 tables, 	INF 
 bucknell, 	INF 
 coverage, 	NAV 
 pre, 	INF 
 bypass, 	NAV 
 pro, 	INF 
 weak, 	INF 
 sierra, 	INF 
 gringo, 	NAV 
 latest, 	NAV 
 55-29, 	INF 
 dealers, 	INF 
 craft, 	INF 
 quilt, 	NAV 
 travis, 	NAV 
 kanye, 	NAV 
 gto, 	NAV 
 baskets, 	INF 
 people, 	INF 
 beyond, 	INF 
 littleton, 	NAV 
 womens, 	NAV 
 bugs, 	INF 
 malloy, 	INF 
 burris, 	NAV 
 games, 	NAV 
 gretchen, 	NAV 
 behr, 	INF 
 hobby, 	NAV 
 heights, 	INF 
 coastal, 	NAV 
 captains, 	INF 
 lotto, 	NAV 
 princeton, 	INF 
 rachel, 	INF 
 aqua, 	INF 
 lemon, 	NAV 
 pus, 	INF 
 simi, 	INF 
 mercedes-benz, 	NAV 
 longview, 	NAV 
 deleto, 	NAV 
 12-tone, 	INF 
 mapping, 	NAV 
 sims, 	INF 
 atlantic, 	INF 
 probation, 	NAV 
 paris, 	INF 
 vespa, 	INF 
 farewell, 	NAV 
 dave's, 	INF 
 craig, 	INF 
 oxford, 	INF 
 opera, 	NAV 
 brandon, 	INF 
 sesame, 	INF 
 sitar, 	INF 
 just, 	NAV 
 silk, 	INF 
 guy, 	NAV 
 theme, 	INF 
 romantic, 	NAV 
 established, 	NAV 
 turks, 	INF 
 friendly, 	INF 
 skating, 	INF 
 harlan, 	NAV 
 gun, 	NAV 
 usao, 	INF 
 caspian, 	INF 
 taxes, 	NAV 
 kah-nee-tah, 	INF 
 attorneys, 	INF 
 remax, 	INF 
 but, 	RES 
 buy, 	INF 
 beef, 	NAV 
 peanutbutter, 	INF 
 travel, 	NAV 
 used, 	NAV 
 been, 	NAV 
 suess, 	NAV 
 beer, 	NAV 
 nightclub, 	INF 
 estes, 	NAV 
 kelly, 	NAV 
 july, 	NAV 
 swing, 	INF 
 paginas, 	NAV 
 connection, 	INF 
 appraiser, 	INF 
 patrick, 	INF 
 zavaleta, 	NAV 
 enterprise, 	NAV 
 paint, 	NAV 
 strip, 	NAV 
 homestead, 	NAV 
 picture, 	NAV 
 cognitive, 	INF 
 1st, 	INF 
 venice, 	NAV 
 stretch, 	NAV 
 mastiff, 	NAV 
 baden, 	NAV 
 scottsdale, 	INF 
 trolley, 	INF 
 presidents, 	INF 
 gary, 	NAV 
 june, 	NAV 
 movies, 	NAV 
 picardy, 	NAV 
 north, 	NAV 
 ernest, 	NAV 
 toyota, 	INF 
 erotic, 	NAV 
 cosmetics, 	INF 
 resort, 	INF 
 l100, 	NAV 
 harley, 	NAV 
 gastric, 	NAV 
 university, 	NAV 
 columbus, 	INF 
 incredible, 	NAV 
 8400, 	INF 
 geraldo, 	NAV 
 inheritance, 	NAV 
 begin, 	INF 
 organ, 	NAV 
 pearls, 	INF 
 tyson, 	INF 
 kidney, 	NAV 
 mower, 	NAV 
 storage, 	NAV 
 river, 	INF 
 2006, 	NAV 
 2007, 	INF 
 dogs, 	NAV 
 2004, 	NAV 
 2005, 	INF 
 2002, 	INF 
 college, 	NAV 
 jeff, 	NAV 
 mitch, 	NAV 
 ghost, 	NAV 
 storm, 	INF 
 lord, 	NAV 
 ga, 	NAV 
 story, 	NAV 
 fm, 	INF 
 fl, 	NAV 
 jeep, 	NAV 
 virgin, 	INF 
 government, 	NAV 
 ft, 	NAV 
 plato, 	INF 
 instant, 	NAV 
 h2, 	NAV 
 christians, 	NAV 
 ibm, 	NAV 
 tampa, 	NAV 
 hd, 	NAV 
 pasta, 	NAV 
 he, 	NAV 
 brett-robinson, 	INF 
 breast, 	NAV 
 gabriel, 	NAV 
 projects, 	NAV 
 magic, 	INF 
 aim, 	INF 
 couture, 	NAV 
 extensor, 	NAV 
 air, 	NAV 
 gs, 	INF 
 bluegrass, 	INF 
 retail, 	NAV 
 go, 	NAV 
 taxpayer, 	NAV 
 du, 	INF 
 212, 	INF 
 assessing, 	INF 
 gift, 	NAV 
 barely, 	NAV 
 dublin, 	NAV 
 aid, 	NAV 
 gatherer, 	NAV 
 idaho, 	NAV 
 de, 	NAV 
 mystic, 	INF 
 emerson, 	NAV 
 di, 	INF 
 battery, 	NAV 
 dj, 	INF 
 loop, 	NAV 
 prieta, 	NAV 
 current, 	INF 
 left, 	NAV 
 do, 	NAV 
 painting, 	NAV 
 loom, 	NAV 
 sheet, 	INF 
 dr, 	NAV 
 look, 	INF 
 beat, 	INF 
 needs, 	NAV 
 alfalfa, 	INF 
 operator, 	NAV 
 gain, 	INF 
 toulouse, 	INF 
 independent, 	NAV 
 crusader, 	INF 
 timberlake, 	INF 
 chocolate, 	NAV 
 el, 	INF 
 suzuki, 	INF 
 ej, 	NAV 
 shag, 	INF 
 titty-fuckig, 	NAV 
 staple, 	NAV 
 legs, 	NAV 
 casino, 	NAV 
 angeles, 	NAV 
 courtyard, 	INF 
 lego, 	INF 
 2000, 	NAV 
 cb, 	INF 
 ca, 	NAV 
 aol, 	INF 
 benton, 	INF 
 versus, 	NAV 
 driving, 	NAV 
 stone, 	INF 
 by, 	NAV 
 lone, 	INF 
 disturbed, 	INF 
 long, 	NAV 
 asian, 	INF 
 tinseltown, 	INF 
 bo, 	INF 
 height-, 	INF 
 deal, 	INF 
 dean, 	INF 
 tommy, 	NAV 
 gill, 	NAV 
 deaf, 	NAV 
 wichita, 	INF 
 be, 	RES 
 victory, 	INF 
 dc, 	NAV 
 submissive, 	INF 
 db, 	INF 
 da, 	INF 
 loma, 	NAV 
 vault, 	INF 
 ana, 	NAV 
 drain, 	NAV 
 samples, 	NAV 
 ct, 	INF 
 equustall, 	INF 
 and, 	NAV 
 holiday, 	NAV 
 rehoboth, 	INF 
 co, 	NAV 
 katharine, 	NAV 
 joaquin, 	NAV 
 played, 	INF 
 ck, 	INF 
 contemporary, 	INF 
 billboard, 	INF 
 c-21, 	INF 
 roman, 	NAV 
 rhymes, 	NAV 
 cf, 	INF 
 phase, 	INF 
 cc, 	INF 
 gymnastics, 	INF 
 berwyn, 	INF 
 aint, 	NAV 
 does, 	NAV 
 bidmc, 	INF 
 necesiten, 	NAV 
 garage, 	NAV 
 routine, 	NAV 
 ama, 	INF 
 husband, 	NAV 
 statistics, 	NAV 
 schwartz, 	INF 
 jerrys, 	INF 
 fidelity, 	NAV 
 apex, 	INF 
 darrin, 	INF 
 ice, 	NAV 
 icd, 	NAV 
 disable, 	NAV 
 restaurants, 	NAV 
 all, 	NAV 
 sample, 	NAV 
 diego, 	INF 
 requirement, 	NAV 
 houses, 	NAV 
 export, 	NAV 
 az, 	INF 
 studios, 	INF 
 petersburg, 	INF 
 speed, 	INF 
 ale, 	INF 
 metro, 	NAV 
 houston, 	NAV 
 boats, 	INF 
 at, 	NAV 
 as, 	NAV 
 ala, 	INF 
 ar, 	NAV 
 game, 	NAV 
 methodology, 	NAV 
 crab, 	INF 
 walter, 	INF 
 au, 	INF 
 dfas, 	INF 
 urban, 	INF 
 al, 	INF 
 color, 	INF 
 am, 	NAV 
 michael, 	NAV 
 pregnancy, 	NAV 
 hershey, 	NAV 
 an, 	NAV 
 ac, 	INF 
 lenco, 	NAV 
 tammy, 	INF 
 aa, 	INF 
 plaza, 	INF 
 pikeville, 	INF 
 basketball, 	NAV 
 covington, 	INF 
 abusive, 	NAV 
 trane, 	INF 
 supreme, 	NAV 
 makeup, 	NAV 
 no, 	NAV 
 nn, 	NAV 
 ignition, 	INF 
 door, 	NAV 
 delco, 	INF 
 ny, 	NAV 
 rangers, 	INF 
 of, 	NAV 
 consultation, 	INF 
 movp, 	NAV 
 abs, 	INF 
 on, 	NAV 
 ok, 	NAV 
 activities, 	INF 
 regime, 	NAV 
 commercial, 	NAV 
 dell, 	INF 
 windsor, 	INF 
 bosch, 	INF 
 or, 	NAV 
 monty, 	NAV 
 questions, 	NAV 
 il., 	INF 
 board, 	NAV 
 colin, 	INF 
 lizards, 	NAV 
 oz, 	NAV 
 douglasville, 	NAV 
 paternity, 	INF 
 pe, 	NAV 
 trans, 	INF 
 wendy, 	INF 
 pa, 	NAV 
 dont, 	NAV 
 pc, 	INF 
 cosby, 	INF 
 rampage, 	INF 
 small, 	NAV 
 pj, 	INF 
 johns, 	NAV 
 plant, 	NAV 
 region, 	NAV 
 plans, 	NAV 
 phonemic, 	INF 
 dzavid, 	NAV 
 donde, 	NAV 
 sediment, 	INF 
 crew, 	INF 
 most, 	NAV 
 lv, 	INF 
 click, 	INF 
 pugs, 	INF 
 plano, 	NAV 
 playboy, 	INF 
 alaskan, 	INF 
 britney, 	INF 
 ma, 	NAV 
 southwest, 	INF 
 tucson, 	INF 
 me, 	NAV 
 hammond, 	INF 
 mi, 	NAV 
 backup, 	NAV 
 mn, 	NAV 
 mr, 	NAV 
 mt, 	INF 
 cemetary, 	NAV 
 ms, 	NAV 
 bumble, 	INF 
 my, 	NAV 
 representatives, 	INF 
 casablanca, 	INF 
 apan, 	INF 
 peggy, 	INF 
 teaching, 	NAV 
 wayne, 	NAV 
 nc, 	NAV 
 route, 	NAV 
 necklaces, 	INF 
 earth, 	NAV 
 nj, 	NAV 
 huguenot, 	NAV 
 saugus, 	INF 
 pontiac, 	INF 
 herford, 	NAV 
 produce, 	INF 
 destin, 	INF 
 jean, 	NAV 
 faberware, 	NAV 
 firstniagara, 	NAV 
 delmar, 	INF 
 l5, 	NAV 
 jl, 	NAV 
 studies, 	INF 
 bracket, 	INF 
 tours, 	INF 
 chinese, 	INF 
 love, 	NAV 
 more, 	INF 
 inc, 	INF 
 laredo, 	INF 
 sherron, 	INF 
 soleil, 	INF 
 trail, 	INF 
 age, 	NAV 
 value, 	INF 
 train, 	NAV 
 inn, 	NAV 
 ky, 	NAV 
 lots, 	NAV 
 weros, 	INF 
 millenium, 	NAV 
 ins, 	INF 
 omega, 	INF 
 ink, 	NAV 
 lg, 	NAV 
 cooter, 	INF 
 la, 	NAV 
 causes, 	NAV 
 hp, 	NAV 
 moon, 	INF 
 parents, 	NAV 
 loss, 	NAV 
 ht, 	NAV 
 silverado, 	INF 
 schlitterbahn, 	INF 
 insight, 	NAV 
 hk, 	NAV 
 monte, 	INF 
 add, 	INF 
 id, 	NAV 
 bdsm, 	INF 
 interchangeable, 	NAV 
 blvd, 	NAV 
 crazy, 	INF 
 if, 	NAV 
 diamond, 	NAV 
 mccarthy, 	INF 
 celebrate, 	INF 
 hydra, 	NAV 
 zoning, 	INF 
 k5, 	INF 
 is, 	NAV 
 doll, 	INF 
 it, 	NAV 
 hooter's, 	NAV 
 agency, 	INF 
 il, 	INF 
 kimbo, 	NAV 
 im, 	NAV 
 in, 	NAV 
 devil, 	INF 
 knot, 	INF 
 filling, 	NAV 
 ada, 	INF 
 aids, 	INF 
 oldnavy, 	NAV 
 quotes, 	NAV 
 sepco, 	INF 
 blue, 	NAV 
 bruising, 	INF 
 enfield, 	NAV 
 continent, 	NAV 
 chistes, 	INF 
 sheriffs, 	NAV 
 local, 	NAV 
 act, 	INF 
 lets, 	NAV 
 s10, 	NAV 
 tempil, 	INF 
 cosmetic, 	INF 
 sandisk, 	INF 
 pups, 	INF 
 greater, 	INF 
 lexington, 	NAV 
 leopoldo, 	NAV 
 weekender, 	INF 
 mrytle, 	INF 
 villanovagroup, 	INF 
 adjustable, 	NAV 
 pasco, 	INF 
 washington, 	NAV 
 aluminum, 	NAV 
 chords, 	NAV 
 nazi, 	NAV 
 virginia, 	INF 
 evanston, 	INF 
 place, 	NAV 
 serious, 	RES 
 muttonhead, 	NAV 
 narratives, 	NAV 
 rubber, 	INF 
 gambia, 	NAV 
 how, 	NAV 
 international, 	NAV 
 builders, 	INF 
 loan, 	NAV 
 wv, 	INF 
 grace, 	NAV 
 cookie, 	INF 
 vx, 	NAV 
 men's, 	NAV 
 sophia, 	INF 
 hot, 	NAV 
 wa, 	INF 
 o'fallon, 	NAV 
 we, 	NAV 
 vaginal, 	NAV 
 killed, 	NAV 
 vt, 	INF 
 desk, 	INF 
 vs, 	NAV 
 punk, 	INF 
 reasons, 	NAV 
 running, 	NAV 
 critical, 	INF 
 personal, 	INF 
 easy, 	NAV 
 uw, 	NAV 
 racing, 	INF 
 grade, 	NAV 
 forza, 	NAV 
 runescape, 	INF 
 va, 	INF 
 hard, 	NAV 
 scratch, 	NAV 
 uk, 	INF 
 park, 	NAV 
 inmate, 	INF 
 trips, 	NAV 
 uf, 	NAV 
 smith, 	NAV 
 us, 	NAV 
 front, 	INF 
 philadelphia, 	NAV 
 suggested, 	INF 
 para, 	NAV 
 weeks, 	INF 
 up, 	NAV 
 caverns, 	INF 
 field, 	NAV 
 banana, 	NAV 
 artists, 	NAV 
 enterprises, 	NAV 
 tx, 	INF 
 isle, 	INF 
 tu, 	INF 
 weapon, 	NAV 
 tv, 	NAV 
 string, 	INF 
 impressive, 	NAV 
 uc, 	NAV 
 part, 	NAV 
 cancer, 	NAV 
 to, 	NAV 
 maternity, 	NAV 
 tn, 	NAV 
 conspiracy, 	NAV 
 hall, 	NAV 
 ts, 	INF 
 v3, 	NAV 
 hale, 	NAV 
 baltimore, 	INF 
 half, 	INF 
 outright, 	NAV 
 irving, 	NAV 
 inspection, 	NAV 
 messenger, 	NAV 
 bathroom, 	INF 
 crop, 	INF 
 hustler, 	NAV 
 winnie, 	INF 
 tb, 	NAV 
 marriott, 	INF 
 anti-abortion, 	INF 
 ss, 	NAV 
 st, 	NAV 
 dept, 	NAV 
 welcome, 	INF 
 tickets, 	NAV 
 depo, 	INF 
 text, 	INF 
 sp, 	NAV 
 manatee, 	INF 
 jonathan, 	NAV 
 so, 	INF 
 eukaryon, 	NAV 
 pump, 	NAV 
 sc, 	NAV 
 opry, 	NAV 
 japanese, 	NAV 
 nation, 	INF 
 james, 	NAV 
 palm, 	NAV 
 palate, 	INF 
 thrift, 	INF 
 jenison, 	INF 
 rv, 	INF 
 natural, 	NAV 
 f250, 	NAV 
 rp, 	NAV 
 birthday, 	NAV 
 hockey, 	INF 
 katrina, 	NAV 
 trade, 	NAV 
 omnipop, 	INF 
 ri, 	INF 
 ceramic, 	INF 
 jewelery, 	NAV 
 rf, 	INF 
 hillsborough, 	NAV 
 rd, 	INF 
 liberty, 	NAV 
 hand, 	NAV 
 reach, 	INF 
 shasta, 	NAV 
 psycho-therapy, 	NAV 
 prince, 	INF 
 nesquik, 	NAV 
 redhead, 	INF 
 four, 	NAV 
 plain, 	INF 
 bergen, 	INF 
 defense, 	INF 
 cleaning, 	NAV 
 track, 	NAV 
 provider, 	INF 
 pornstar, 	INF 
 medicaid, 	NAV 
 pans, 	INF 
 school, 	NAV 
 appliances, 	INF 
 r6, 	INF 
 tracy, 	NAV 
 eteamz, 	NAV 
 pr, 	INF 
 shell, 	INF 
 naples, 	NAV 
 romeo, 	NAV 
 test, 	NAV 
 ipsen, 	NAV 
 sucking, 	INF 
 281, 	NAV 
 guardian, 	NAV 
 city, 	NAV 
 dealer, 	INF 
 open, 	NAV 
 airport, 	NAV 
 are, 	NAV 
 forclosure, 	INF 
 deaths, 	NAV 
 flexlite, 	NAV 
 cleo's, 	INF 
 essay, 	NAV 
 verna, 	NAV 
 brothers, 	NAV 
 projector, 	NAV 
 plus, 	INF 
 journals, 	NAV 
 problems, 	INF 
 form, 	NAV 
 delta, 	INF 
 art, 	INF 
 spears, 	INF 
 marietta, 	INF 
 bartenders, 	INF 
 interaction, 	NAV 
 fort, 	NAV 
 strategic, 	INF 
 hairstylists, 	NAV 
 jamal, 	NAV 
 mary's, 	NAV 
 present, 	NAV 
 asf, 	INF 
 fgcu, 	INF 
 laurel, 	NAV 
 fontina, 	NAV 
 knitting, 	NAV 
 lauren, 	NAV 
 adults, 	INF 
 contractors, 	INF 
 costa, 	INF 
 twinks, 	NAV 
 picnic, 	INF 
 jaguar, 	NAV 
 skamper, 	INF 
 ship, 	NAV 
 dallas, 	NAV 
 crum, 	INF 
 pain, 	NAV 
 contact, 	INF 
 paid, 	INF 
 southern, 	NAV 
 removing, 	INF 
 tropea, 	NAV 
 cruz, 	INF 
 money, 	NAV 
 wkyt, 	INF 
 fontana, 	NAV 
 ford, 	NAV 
 thomas, 	INF 
 formosa, 	NAV 
 logo, 	NAV 
 anthracis, 	INF 
 bunny, 	INF 
 signed, 	NAV 
 haven, 	NAV 
 point, 	NAV 
 5815, 	INF 
 delux, 	INF 
 twain, 	INF 
 bacteria, 	INF 
 kensington, 	NAV 
 attack, 	INF 
 scussett, 	INF 
 stones, 	INF 
 gameboy, 	NAV 
 shop, 	NAV 
 hate, 	INF 
 jersey, 	NAV 
 little, 	NAV 
 show, 	NAV 
 natalie, 	NAV 
 loyola, 	INF 
 pack, 	INF 
 shot, 	INF 
 hopkins, 	NAV 
 lesly, 	NAV 
 decor, 	INF 
 motels, 	NAV 
 neugarten's, 	NAV 
 maryland, 	NAV 
 stripper, 	INF 
 fisher, 	INF 
 shoe, 	INF 
 toppers, 	NAV 
 systems, 	INF 
 alvarez, 	INF 
 riverwalk, 	INF 
 rhino, 	INF 
 shawnee, 	INF 
 sinus, 	NAV 
 food, 	NAV 
 images, 	NAV 
 transunion, 	NAV 
 dearborn, 	INF 
 babies, 	INF 
 ata, 	INF 
 have, 	NAV 
 philosophical, 	NAV 
 ass, 	NAV 
 za, 	INF 
 object, 	INF 
 chondra, 	INF 
 xxx, 	NAV 
 girl, 	NAV 
 accidents, 	INF 
 protected, 	NAV 
 racquetball, 	INF 
 fresh, 	NAV 
 kelvin, 	NAV 
 pads, 	NAV 
 hemiarthroplasty, 	INF 
 ebay, 	NAV 
 denise, 	INF 
 forms, 	NAV 
 250, 	NAV 
 saybrook, 	INF 
 folk, 	NAV 
 ya, 	NAV 
 naruto, 	INF 
 spanked, 	INF 
 lock, 	INF 
 atv, 	INF 
 lansing, 	NAV 
 fanfiction, 	NAV 
 john's, 	INF 
 george, 	NAV 
 ideals, 	NAV 
 motors, 	NAV 
 mental, 	NAV 
 creeting, 	NAV 
 mercer, 	NAV 
 boardway, 	INF 
 chance, 	NAV 
 olive, 	NAV 
 rochester, 	NAV 
 noir, 	NAV 
 nashville, 	NAV 
 sunshadow, 	INF 
 right, 	NAV 
 nielsen, 	NAV 
 screaming, 	NAV 
 borders, 	INF 
 thistle, 	INF 
 poppit, 	INF 
 vintara, 	INF 
 930, 	INF 
 junction, 	INF 
 hits, 	INF 
 touch, 	NAV 
 native, 	NAV 
 squirts, 	INF 
 lees, 	NAV 
 codes, 	NAV 
 chanel, 	INF 
 comparing, 	INF 
 made, 	NAV 
 madd, 	NAV 
 net, 	INF 
 924, 	NAV 
 downloads, 	INF 
 fantasy, 	INF 
 homeschoolers, 	INF 
 token, 	NAV 
 suburb, 	INF 
 springfield, 	NAV 
 blairsville, 	INF 
 sickel, 	NAV 
 sarah, 	INF 
 trial, 	INF 
 cocktails, 	INF 
 pepperdine, 	INF 
 classes, 	INF 
 omar, 	NAV 
 jazz, 	INF 
 phat, 	INF 
 holocaust, 	NAV 
 lunacy, 	INF 
 911, 	INF 
 bridgeport, 	NAV 
 brazil, 	INF 
 new, 	NAV 
 florence, 	NAV 
 including, 	NAV 
 guess, 	NAV 
 cardiovascular, 	NAV 
 having, 	NAV 
 dominoes, 	INF 
 bloom2, 	INF 
 ariau, 	INF 
 razr, 	INF 
 change, 	NAV 
 caterpiller, 	INF 
 lead, 	NAV 
 kong, 	NAV 
 kicker, 	NAV 
 consumer, 	INF 
 capital, 	INF 
 surgery, 	NAV 
 7th, 	INF 
 toning, 	INF 
 march, 	NAV 
 medical, 	NAV 
 bigtitmom, 	INF 
 evaporative, 	INF 
 marco, 	NAV 
 toddler, 	NAV 
 molera, 	INF 
 fax, 	INF 
 lilac, 	INF 
 watch, 	INF 
 wheels, 	NAV 
 fat, 	NAV 
 far, 	NAV 
 display, 	NAV 
 fan, 	NAV 
 sonoma, 	INF 
 roof, 	NAV 
 alternator, 	INF 
 chaney, 	INF 
 discounted, 	INF 
 whelihans, 	INF 
 biblical, 	INF 
 make, 	NAV 
 room, 	NAV 
 olympic, 	INF 
 indoor, 	NAV 
 therapeutic, 	NAV 
 texas, 	NAV 
 hawthorn, 	INF 
 through, 	NAV 
 960, 	INF 
 education, 	NAV 
 olympia, 	NAV 
 hotels, 	NAV 
 atomic, 	INF 
 glen, 	NAV 
 wireless, 	NAV 
 cheats, 	INF 
 kool, 	NAV 
 tuxedo, 	INF 
 clyde's, 	INF 
 cottage, 	NAV 
 mazda, 	INF 
 naomi, 	NAV 
 20medical, 	INF 
 universal, 	NAV 
 gomez, 	NAV 
 classic, 	INF 
 mail, 	NAV 
 booking, 	INF 
 006, 	NAV 
 myers, 	NAV 
 nbc, 	NAV 
 lonnie, 	INF 
 rinker, 	NAV 
 deposit, 	NAV 
 kalmia, 	NAV 
 roth, 	INF 
 joyce, 	NAV 
 honey, 	NAV 
 rank, 	INF 
 dc-71, 	INF 
 puzzles, 	NAV 
 social, 	NAV 
 report, 	INF 
 mechanical, 	INF 
 ladie's, 	NAV 
 hill, 	NAV 
 reported, 	INF 
 operativna, 	NAV 
 asphalt, 	INF 
 whitetail, 	INF 
 sequoia, 	INF 
 comps, 	INF 
 phantom, 	NAV 
 newent, 	NAV 
 creators, 	NAV 
 rose, 	INF 
 cornerstone, 	INF 
 honda, 	NAV 
 vacation, 	NAV 
 rosa, 	INF 
 cardboard, 	NAV 
 shakira, 	NAV 
 disclosure, 	NAV 
 chiseled, 	INF 
 antique, 	INF 
 cancun, 	NAV 
 europe, 	NAV 
 torretta, 	NAV 
 medtronics, 	NAV 
 stevie, 	INF 
 deciduous, 	NAV 
 williston, 	NAV 
 johnny, 	NAV 
 diabetes, 	INF 
 franklin, 	NAV 
 megaman, 	INF 
 gabrielino, 	NAV 
 build, 	NAV 
 vancouver, 	NAV 
 carbide, 	INF 
 banker, 	INF 
 distance, 	NAV 
 mountains, 	INF 
 benign, 	NAV 
 riding, 	NAV 
 fiction, 	NAV 
 gotto, 	INF 
 mobility, 	INF 
 demarco, 	NAV 
 rape, 	NAV 
 medication, 	NAV 
 water, 	NAV 
 loreal, 	NAV 
 vintage, 	INF 
 faith, 	INF 
 nfpa, 	INF 
 smallest, 	NAV 
 cruises, 	INF 
 mucos, 	NAV 
 movie, 	NAV 
 diploma, 	NAV 
 kristi, 	NAV 
 pilots, 	INF 
 boyfriend, 	INF 
 club, 	NAV 
 modular, 	NAV 
 guitar, 	NAV 
 zack, 	INF 
 square, 	INF 
 fayette, 	NAV 
 apply, 	NAV 
 animated, 	INF 
 fahrenheit, 	INF 
 roxy, 	INF 
 furniture, 	NAV 
 cherry's, 	INF 
 hindu, 	NAV 
 january, 	NAV 
 action, 	NAV 
 2500, 	NAV 
 resin, 	NAV 
 nationalization, 	NAV 
 scanner, 	NAV 
 toshiba, 	INF 
 lakeland, 	NAV 
 eye, 	NAV 
 punch, 	INF 
 duckhouse, 	NAV 
 mountaine, 	NAV 
 softball, 	INF 
 jefferson, 	INF 
 wiring, 	NAV 
 cedar, 	INF 
 piercings, 	INF 
 barbara, 	INF 
 filing, 	NAV 
 satanic, 	NAV 
 roddrick, 	INF 
 blackberry, 	NAV 
 console, 	INF 
 corporate, 	INF 
 dress, 	NAV 
 apple, 	NAV 
 permits, 	INF 
 holistic, 	NAV 
 layouts, 	INF 
 forcast, 	INF 
 expansion, 	INF 
 westwood, 	NAV 
 browning, 	INF 
 steroids, 	NAV 
 attache, 	INF 
 circle, 	INF 
 requirements, 	NAV 
 amputation, 	INF 
 investment, 	INF 
 rate, 	INF 
 recordable, 	INF 
 motorcycle, 	NAV 
 fotos, 	NAV 
 mxt, 	INF 
 recetas, 	NAV 
 larceny, 	NAV 
 invenzioni, 	NAV 
 into, 	NAV 
 hubert, 	NAV 
 hint, 	NAV 
 rockabilly, 	INF 
 fairfield, 	NAV 
 daily, 	INF 
 lucille, 	NAV 
 luxury, 	INF 
 grapevinemills, 	INF 
 queens, 	NAV 
 bears, 	INF 
 babybedding, 	INF 
 things, 	NAV 
 tigers, 	INF 
 dresher, 	NAV 
 estate, 	NAV 
 treatment, 	NAV 
 christianschool, 	NAV 
 peekskill, 	INF 
 lowell, 	NAV 
 nyc, 	NAV 
 temperature, 	INF 
 candle, 	INF 
 jones, 	INF 
 hide, 	NAV 
 orgasm, 	INF 
 richard, 	INF 
 year, 	NAV 
 jake, 	NAV 
 mileage, 	NAV 
 insitute, 	INF 
 california, 	NAV 
 hospice, 	NAV 
 disney, 	INF 
 rocawear, 	INF 
 assn, 	INF 
 roles, 	INF 
 linens, 	NAV 
 resuscitate, 	INF 
 nautical, 	NAV 
 hardwax, 	INF 
 chase, 	INF 
 nwc, 	NAV 
 rolex, 	NAV 
 bertera, 	INF 
 adventure, 	INF 
 bridget, 	INF 
 braunfels, 	NAV 
 plasama, 	INF 
 exeter, 	NAV 
 montessorri, 	NAV 
 abdominal, 	INF 
 buffalo, 	NAV 
 franchise, 	INF 
 mound, 	NAV 
 lighthouse, 	NAV 
 tennessee, 	NAV 
 learning, 	NAV 
 teens, 	INF 
 jail, 	NAV 
 matt, 	NAV 
 merian, 	INF 
 prairie, 	INF 
 math, 	NAV 
 trans-bridge, 	NAV 
 nun, 	NAV 
 mount, 	NAV 
 basket, 	NAV 
 nut, 	NAV 
 chart, 	NAV 
 grants, 	NAV 
 garden, 	NAV 
 charo, 	INF 
 tenn., 	INF 
 vertical, 	NAV 
 cemetery, 	INF 
 mendenhall, 	NAV 
 randy, 	NAV 
 2480, 	NAV 
 breckenridge, 	INF 
 springs, 	INF 
 dutch, 	NAV 
 germany, 	NAV 
 hartwell, 	NAV 
 china, 	NAV 
 vest, 	INF 
 grover, 	INF 
 orange, 	NAV 
 ranch, 	INF 
 tornado's, 	NAV 
 forest, 	NAV 
 youth, 	NAV 
 madison, 	NAV 
 siamese, 	INF 
 pools, 	NAV 
 bernadine, 	INF 
 eps, 	INF 
 eggs, 	INF 
 email, 	NAV 
 solms, 	INF 
 islands, 	NAV 
 steelers, 	INF 
 bingo, 	INF 
 womyn, 	INF 
 engagement, 	NAV 
 legal, 	NAV 
 tallahassee, 	INF 
 famous, 	NAV 
 mouse, 	NAV 
 illinois, 	NAV 
 jambalaya, 	NAV 
 helter, 	NAV 
 jared, 	NAV 
 child, 	INF 
 rustoleum, 	INF 
 unusual, 	INF 
 synopsis, 	INF 
 bobby, 	INF 
 mayo, 	NAV 
 generac, 	NAV 
 capitol, 	INF 
 moorish, 	NAV 
 esl, 	INF 
 rentals, 	INF 
 threader, 	NAV 
 community, 	INF 
 adult, 	NAV 
 general, 	NAV 
 mcraven, 	NAV 
 rhode, 	NAV 
 foods, 	NAV 
 effect, 	NAV 
 ferry, 	NAV 
 ninja, 	NAV 
 seasons, 	INF 
 whisky, 	INF 
 scan, 	NAV 
 high, 	NAV 
 very, 	RES 
 garmin, 	INF 
 masquerade, 	NAV 
 non-taxable, 	INF 
 revolution, 	INF 
 anthology, 	NAV 
 riverdale, 	INF 
 josephs, 	INF 
 info, 	NAV 
 editor's, 	INF 
 certificate, 	NAV 
 nematodes, 	NAV 
 sheriff, 	INF 
 mile, 	NAV 
 devine, 	NAV 
 exchange, 	INF 
 coolant, 	INF 
 boise, 	INF 
 elite, 	NAV 
 lauderdale, 	NAV 
 reproductions, 	INF 
 overseas, 	NAV 
 gmac, 	NAV 
 notre, 	INF 
 waylon, 	INF 
 non, 	NAV 
 not, 	NAV 
 soldiers, 	INF 
 start, 	NAV 
 stars, 	NAV 
 tropicana, 	INF 
 tulsa, 	INF 
 physics, 	NAV 
 mame, 	NAV 
 waubonsie, 	INF 
 emt, 	INF 
 walgreens, 	INF 
 emergent, 	INF 
 techniques, 	NAV 
 boulder, 	NAV 
 valley, 	NAV 
 pythagorean, 	NAV 
 towers, 	INF 
 starting, 	NAV 
 ene, 	NAV 
 1905-s303, 	INF 
 roberts, 	NAV 
 aggressive, 	INF 
 district, 	NAV 
 mini, 	NAV 
 end, 	NAV 
 karate, 	NAV 
 stereos, 	INF 
 hartville, 	INF 
 nurses, 	INF 
 beauties, 	NAV 
 kristin, 	NAV 
 demoderby, 	INF 
 male, 	NAV 
 mint, 	NAV 
 fallacies, 	NAV 
 process, 	NAV 
 chair, 	NAV 
 ryman, 	INF 
 chaim, 	INF 
 tequila, 	INF 
 pueblo, 	INF 
 parole, 	INF 
 mall, 	NAV 
 reading, 	INF 
 italian, 	NAV 
 goodwill, 	INF 
 beach, 	NAV 
 transit, 	INF 
 obeseity, 	NAV 
 skin, 	NAV 
 mass, 	NAV 
 reports-, 	INF 
 coupons, 	NAV 
 lesbian, 	NAV 
 photo's, 	INF 
 quincy, 	INF 
 8mm, 	INF 
 concord, 	INF 
 egr, 	NAV 
 spinal, 	NAV 
 parenting, 	INF 
 marc, 	NAV 
 bellingham, 	INF 
 dream, 	NAV 
 mark, 	NAV 
 beyonce, 	INF 
 daddys, 	INF 
 ranks, 	NAV 
 quakers, 	INF 
 chevrolet, 	NAV 
 105.9, 	INF 
 fountain, 	INF 
 libre, 	NAV 
 nordictrack, 	NAV 
 randle, 	INF 
 mary, 	NAV 
 senior, 	INF 
 pinellas, 	INF 
 warminster, 	INF 
 realgy, 	NAV 
 jane, 	NAV 
 skelter, 	NAV 
 state, 	NAV 
 dvds, 	INF 
 interacial, 	INF 
 compliled, 	NAV 
 blog, 	NAV 
 restaurant, 	INF 
 apartments, 	NAV 
 chico, 	NAV 
 farms, 	NAV 
 quote, 	INF 
 premiere, 	NAV 
 won, 	NAV 
 oasis, 	INF 
 bayshore, 	INF 
 greatest, 	NAV 
 fathersday, 	NAV 
 goals, 	INF 
 delears, 	INF 
 maps, 	NAV 
 twitching, 	INF 
 address, 	INF 
 shoulder, 	INF 
 athens, 	INF 
 detroit, 	NAV 
 miss, 	NAV 
 total, 	NAV 
 need, 	INF 
 using, 	NAV 
 mountain, 	NAV 
 comerica, 	INF 
 fish, 	NAV 
 baylor, 	INF 
 over, 	NAV 
 free, 	NAV 
 discs, 	INF 
 fred, 	NAV 
 perusquia, 	INF 
 search, 	INF 
 camping, 	INF 
 simba, 	INF 
 panasonic, 	NAV 
 armstrong's, 	NAV 
 creative, 	INF 
 basement, 	INF 
 parent, 	INF 
 hollywood, 	INF 
 number, 	NAV 
 happy's, 	NAV 
 february, 	NAV 
 sociologist, 	NAV 
 deere, 	NAV 
 arbors, 	INF 
 voltage, 	NAV 
 bully's, 	NAV 
 hermle, 	NAV 
 seating, 	INF 
 computer, 	NAV 
 breeders, 	INF 
 bleaching, 	INF 
 implant, 	INF 
 restuarants, 	INF 
 oil, 	NAV 
 barney, 	NAV 
 toxaway, 	NAV 
 sand, 	INF 
 vega, 	NAV 
 firm, 	INF 
 nehi, 	NAV 
 web, 	INF 
 films, 	INF 
 preteen, 	NAV 
 living, 	INF 
 fire, 	NAV 
 oahu, 	INF 
 arrested, 	INF 
 ucsd, 	INF 
 carlebach, 	INF 
 tocharian, 	INF 
 glasgow, 	NAV 
 banks, 	INF 
 heinz, 	NAV 
 auctions, 	INF 
 monroe, 	INF 
 roanoke, 	INF 
 taste, 	INF 
 heron, 	INF 
 donnie, 	NAV 
 who, 	NAV 
 stained, 	INF 
 polk, 	INF 
 facts, 	NAV 
 oval, 	NAV 
 magnolia, 	NAV 
 abby, 	INF 
 dealerships, 	NAV 
 holyoke, 	NAV 
 cardine, 	INF 
 get, 	NAV 
 sale, 	NAV 
 jacksonville, 	NAV 
 armadillo, 	INF 
 near, 	NAV 
 ged, 	NAV 
 example, 	NAV 
 gem, 	NAV 
 i'm, 	INF 
 gel, 	NAV 
 pound, 	NAV 
 marvin, 	NAV 
 salt, 	INF 
 nickle, 	NAV 
 understanding, 	INF 
 today, 	INF 
 area, 	NAV 
 ramsey, 	NAV 
 style, 	NAV 
 doorbell, 	NAV 
 wit, 	NAV 
 decals, 	NAV 
 doyle, 	INF 
 metallic, 	INF 
 types, 	NAV 
 wiz, 	INF 
 sako, 	INF 
 coupon, 	NAV 
 five, 	NAV 
 poly, 	INF 
 polo, 	NAV 
 dominican, 	INF 
 still, 	RES 
 win, 	NAV 
 accessories, 	INF 
 newborn, 	NAV 
 wik, 	INF 
 reservations, 	NAV 
 snowmobiling, 	INF 
 message, 	NAV 
 goats, 	INF 
 hitachi, 	NAV 
 connecticut, 	INF 
 mission, 	NAV 
 off, 	NAV 
 wia, 	INF 
 why, 	NAV 
 bounder, 	INF 
 bands, 	INF 
 tanker, 	INF 
 anyways, 	INF 
 court, 	NAV 
 french, 	NAV 
 homemade, 	NAV 
 cure, 	NAV 
 vincents, 	NAV 
 operation, 	NAV 
 emerald, 	INF 
 bread, 	INF 
 only, 	INF 
 says, 	INF 
 import, 	INF 
 central, 	INF 
 betty, 	INF 
 curt, 	INF 
 ring, 	INF 
 creating, 	INF 
 fetch, 	NAV 
 20death, 	INF 
 services, 	NAV 
 heart, 	NAV 
 gayle's, 	INF 
 museum, 	INF 
 novelty, 	NAV 
 discount, 	INF 
 gas, 	NAV 
 prime, 	INF 
 caroline, 	INF 
 roosevelt, 	INF 
 traffic, 	NAV 
 katie, 	NAV 
 carolina, 	NAV 
 gay, 	NAV 
 nevada, 	INF 
 poster, 	INF 
 austria, 	NAV 
 gap, 	INF 
 creation, 	NAV 
 indiana, 	NAV 
 mosquito, 	NAV 
 datman, 	INF 
 inmates, 	NAV 
 moment, 	INF 
 recipes, 	INF 
 odors, 	INF 
 protect, 	INF 
 cute, 	INF 
 uterus, 	NAV 
 jackson, 	INF 
 oak, 	NAV 
 indians, 	NAV 
 dollar, 	INF 
 skokie, 	INF 
 punching, 	NAV 
 clock, 	NAV 
 trout, 	INF 
 hayward, 	NAV 
 billed, 	NAV 
 flight, 	NAV 
 choker, 	INF 
 plumbing, 	INF 
 voucher, 	INF 
 durg, 	NAV 
 save, 	INF 
 location, 	NAV 
 handlery, 	NAV 
 perspectives, 	INF 
 nursery, 	NAV 
 peabody, 	NAV 
 nys, 	NAV 
 volkswagen, 	INF 
 speeding, 	NAV 
 orland, 	NAV 
 clip-on, 	INF 
 official, 	NAV 
 idol, 	INF 
 coeur, 	INF 
 biology, 	INF 
 republic, 	INF 
 musical, 	NAV 
 isley, 	NAV 
 enamel, 	NAV 
 heavy, 	NAV 
 machine, 	NAV 
 professional, 	INF 
 copies, 	NAV 
 pizza, 	INF 
 bulletin, 	INF 
 centimeters, 	INF 
 skyfi, 	INF 
 redfish, 	INF 
 cotton, 	INF 
 laguna, 	NAV 
 projection, 	INF 
 wax, 	INF 
 way, 	NAV 
 crackerjack, 	INF 
 armstrong, 	NAV 
 symphony, 	NAV 
 from, 	NAV 
 monongahela, 	INF 
 believe, 	INF 
 war, 	NAV 
 was, 	NAV 
 risk, 	NAV 
 duty, 	INF 
 humphrey, 	NAV 
 rise, 	INF 
 brookhaven, 	NAV 
 alligator, 	INF 
 brenham, 	INF 
 driver, 	INF 
 arms, 	INF 
 actors, 	NAV 
 filene's, 	NAV 
 between, 	NAV 
 healthcare, 	NAV 
 maine, 	NAV 
 caregiver, 	INF 
 standard, 	INF 
 bruce, 	INF 
 mulder, 	NAV 
 swaps, 	INF 
 pan-hellenic, 	INF 
 episcopal, 	NAV 
 susan, 	NAV 
 growing, 	NAV 
 nancy, 	NAV 
 motorsports, 	NAV 
 print, 	INF 
 rite, 	INF 
 renting, 	INF 
 carl's, 	INF 
 wah, 	INF 
 chatham, 	INF 
 providence, 	INF 
 found, 	NAV 
 juicy, 	NAV 
 sopranos, 	INF 
 boheme, 	NAV 
 arts, 	NAV 
 wood, 	NAV 
 myspace, 	NAV 
 stella, 	INF 
 pride, 	NAV 
 installation, 	INF 
 unlocked, 	INF 
 presidential, 	NAV 
 lifted, 	NAV 
 hodges, 	NAV 
 calories, 	INF 
 villas, 	INF 
 dying, 	NAV 
 francis, 	NAV 
 kitchen, 	NAV 
 lcos, 	NAV 
 tempered, 	NAV 
 price, 	INF 
 london, 	NAV 
 harrison, 	NAV 
 tummy, 	INF 
 coming, 	NAV 
 rezenik, 	NAV 
 own, 	NAV 
 women's, 	NAV 
 face, 	NAV 
 arrt, 	INF 
 wheel, 	INF 
 next, 	INF 
 bells, 	INF 
 lipitor, 	NAV 
 digital, 	NAV 
 belly, 	INF 
 decibel, 	INF 
 marys, 	NAV 
 pence, 	INF 
 superpages, 	INF 
 motor, 	NAV 
 festival, 	NAV 
 kitty, 	NAV 
 hair, 	NAV 
 detention, 	NAV 
 thoreau, 	NAV 
 news, 	NAV 
 permanente, 	NAV 
 bigbie, 	NAV 
 bianca, 	INF 
 paperwork, 	INF 
 fact, 	NAV 
 collisions, 	INF 
 producer, 	INF 
 grams, 	NAV 
 gallatin, 	INF 
 grocery, 	NAV 
 oregon, 	NAV 
 dreams, 	INF 
 caladium, 	INF 
 nero, 	INF 
 redwood, 	INF 
 wadsworth, 	INF 
 takes, 	INF 
 allen, 	INF 
 sturgeon, 	NAV 
 hack, 	NAV 
 duke, 	NAV 
 hirschsprung's, 	NAV 
 marry, 	NAV 
 fsu, 	INF 
 what's, 	NAV 
 cannibal, 	INF 
 victim, 	NAV 
 sampson, 	INF 
 otb, 	NAV 
 mummies, 	NAV 
 fun, 	NAV 
 bakers, 	INF 
 size, 	NAV 
 angel, 	NAV 
 fife, 	NAV 
 cressett, 	INF 
 vva, 	INF 
 anger, 	INF 
 roads, 	NAV 
 god's, 	NAV 
 tube, 	INF 
 classified, 	INF 
 well, 	NAV 
 dumb, 	NAV 
 brunswick, 	INF 
 ginko, 	NAV 
 merrimack, 	INF 
 gotta, 	INF 
 morristown, 	NAV 
 cocktail, 	NAV 
 supply, 	INF 
 ryan, 	INF 
 sydney, 	INF 
 sunbeam, 	INF 
 rain, 	INF 
 animal, 	INF 
 clip, 	NAV 
 geographic, 	NAV 
 cups, 	NAV 
 fibromyalgia, 	NAV 
 ness, 	INF 
 becton, 	INF 
 tuck, 	NAV 
 muscular, 	NAV 
 shirtless, 	INF 
 genecide, 	INF 
 pleasanton, 	NAV 
 reggie, 	INF 
 units, 	NAV 
 whistle, 	NAV 
 ansestry, 	INF 
 maclura, 	NAV 
 sewing, 	NAV 
 ft., 	INF 
 resume, 	NAV 
 wolf, 	INF 
 saskatchewan, 	INF 
 determined, 	INF 
 oun, 	NAV 
 purcell, 	INF 
 operations, 	INF 
 mohave, 	NAV 
 our, 	NAV 
 unheard, 	INF 
 employees, 	NAV 
 waste, 	INF 
 fox, 	NAV 
 for, 	NAV 
 ashley, 	INF 
 went, 	NAV 
 jenny, 	INF 
 vip, 	INF 
 authors, 	INF 
 bethlehem, 	INF 
 critiques, 	INF 
 file, 	NAV 
 continental.com, 	INF 
 vin, 	INF 
 prevention, 	NAV 
 fredericksburg, 	NAV 
 groups, 	NAV 
 satire, 	NAV 
 encrusted, 	INF 
 information, 	NAV 
 gulfport, 	NAV 
 stamina, 	NAV 
 grass, 	NAV 
 housing, 	NAV 
 airplane, 	INF 
 cricket, 	INF 
 compare, 	INF 
 minister, 	NAV 
 table, 	NAV 
 fair, 	NAV 
 jogunn, 	NAV 
 create, 	NAV 
 manchengo, 	NAV 
 saleen, 	INF 
 witholding, 	NAV 
 supervisor, 	NAV 
 clown, 	INF 
 chester, 	NAV 
 ashlee, 	NAV 
 vomit, 	INF 
 lynchburg, 	INF 
 kget, 	INF 
 cartridges, 	NAV 
 character, 	INF 
 cloth, 	NAV 
 mediterranean, 	NAV 
 union, 	NAV 
 107, 	INF 
 fake, 	NAV 
 salmen, 	INF 
 coldwell, 	INF 
 frequently, 	NAV 
 furneral, 	NAV 
 hudson's, 	NAV 
 united, 	NAV 
 desert, 	NAV 
 diamonds, 	INF 
 meadows, 	NAV 
 cabeza, 	INF 
 crystal, 	INF 
 saint, 	NAV 
 livestock, 	INF 
 symptoms, 	INF 
 snake, 	INF 
 dinwiddie, 	INF 
 fall, 	INF 
 maplewood, 	INF 
 preaching, 	INF 
 flanders, 	NAV 
 condo, 	NAV 
 old, 	NAV 
 boothwyn, 	INF 
 rancho, 	INF 
 race, 	NAV 
 ole, 	NAV 
 were, 	RES 
 disne, 	INF 
 grand, 	NAV 
 corbia, 	INF 
 three, 	NAV 
 marshalltown, 	NAV 
 vo5, 	INF 
 orvis, 	NAV 
 podiatric, 	NAV 
 cards, 	INF 
 diarrhea, 	INF 
 cavalier, 	INF 
 polishing, 	INF 
 rado, 	INF 
 victims, 	INF 
 letter, 	NAV 
 videos, 	NAV 
 global, 	NAV 
 flu, 	INF 
 albert, 	INF 
 pacific, 	INF 
 cattle, 	NAV 
 nextel, 	INF 
 affordable, 	INF 
 aitkin, 	INF 
 fly, 	INF 
 clerk, 	INF 
 program, 	NAV 
 company, 	INF 
 roses, 	INF 
 fran, 	NAV 
 word, 	NAV 
 palace, 	NAV 
 management, 	INF 
 ever, 	NAV 
 west, 	NAV 
 campus, 	INF 
 canoscan, 	INF 
 greenfield, 	NAV 
 one, 	NAV 
 monaco, 	NAV 
 staion, 	INF 
 recent, 	NAV 
 sphinx, 	NAV 
 officer, 	NAV 
 amtrak, 	INF 
 rico, 	NAV 
 york, 	NAV 
 perfect, 	NAV 
 fine, 	NAV 
 kphx, 	NAV 
 find, 	NAV 
 wheat, 	NAV 
 film, 	NAV 
 profit, 	NAV 
 rice, 	INF 
 separation, 	NAV 
 wachovia, 	INF 
 undergraduate, 	NAV 
 families, 	INF 
 berkeley, 	NAV 
 publication, 	INF 
 cumberland, 	INF 
 outer, 	INF 
 oo7, 	NAV 
 coloring, 	NAV 
 sitcom, 	NAV 
 wrestlemania, 	INF 
 benckmark, 	INF 
 channel, 	INF 
 ralph, 	INF 
 linda, 	NAV 
 parkersburg, 	INF 
 seminary, 	NAV 
 screw-vent, 	INF 
 time, 	NAV 
 married, 	NAV 
 theological, 	NAV 
 kiwi, 	NAV 
 corinth, 	INF 
 tahoe, 	NAV 
 lakeside, 	NAV 
 video, 	NAV 
 showy, 	INF 
 poetic, 	NAV 
 outlets, 	NAV 
 shows, 	NAV 
 neurogenic, 	INF 
 pallotti, 	INF 
 pocket, 	INF 
 niagara, 	NAV 
 alex, 	INF 
 malls, 	NAV 
 underground, 	INF 
 brooklyn, 	INF 
 reflexology, 	NAV 
 gordon, 	NAV 
 scrapbooking, 	INF 
 queen, 	NAV 
 carlo, 	INF 
 motorola, 	NAV 
 neoclassical, 	INF 
 mateo, 	NAV 
 orzo, 	INF 
 saftey, 	INF 
 usdoj.gov, 	INF 
 lived, 	NAV 
 elizabeth, 	NAV 
 bqli, 	INF 
 meaning, 	NAV 
 register, 	INF 
 veterans, 	INF 
 bass, 	INF 
 elegant, 	INF 
 tile, 	NAV 
 kyra, 	NAV 
 public, 	NAV 
 blits, 	NAV 
 vcr, 	NAV 
 gateway, 	NAV 
 client, 	INF 
 ditch, 	INF 
 webshot, 	INF 
 microwave, 	INF 
 coca, 	INF 
 ritchie, 	INF 
 cock, 	NAV 
 kiss, 	INF 
 band, 	INF 
 terminal, 	NAV 
 michelle, 	INF 
 invasion, 	NAV 
 bank, 	INF 
 hood, 	NAV 
 duncan, 	NAV 
 trains, 	INF 
 methodist, 	INF 
 hook, 	NAV 
 vital, 	NAV 
 hoop, 	INF 
 code, 	INF 
 i830, 	INF 
 damaging, 	INF 
 dunn's, 	NAV 
 disorder, 	NAV 
 orton, 	NAV 
 veterinary, 	NAV 
 names, 	NAV 
 dam, 	INF 
 mequon, 	NAV 
 day, 	NAV 
 prefer, 	NAV 
 fast, 	NAV 
 barcellona, 	INF 
 large, 	NAV 
 hope, 	NAV 
 named, 	NAV 
 insurance, 	NAV 
 van, 	INF 
 bill, 	RES 
 busty, 	NAV 
 songs, 	NAV 
 winston, 	INF 
 asbury, 	INF 
 fare, 	INF 
 i860, 	NAV 
 lab, 	NAV 
 berggren, 	INF 
 honeymoon, 	NAV 
 weatherchannel, 	INF 
 farm, 	NAV 
 coal, 	NAV 
 sites.fashion, 	INF 
 creek, 	INF 
 disability, 	NAV 
 rapids, 	INF 
 tanningbed, 	INF 
 decorating, 	INF 
 coat, 	INF 
 vitual, 	NAV 
 las, 	NAV 
 law, 	INF 
 anniversary, 	INF 
 precision, 	INF 
 april, 	NAV 
 dcf, 	INF 
 corinne, 	INF 
 cable, 	INF 
 scenic, 	INF 
 planned, 	NAV 
 photo, 	NAV 
 photos, 	NAV 
 disaters, 	NAV 
 great, 	NAV 
 kits, 	INF 
 acid, 	NAV 
 source, 	NAV 
 halina, 	NAV 
 take, 	INF 
 caring, 	INF 
 lbs, 	INF 
 gentlemen, 	NAV 
 sacramento, 	INF 
 tarp, 	NAV 
 palosi, 	INF 
 clearfield, 	INF 
 shuttle, 	NAV 
 poetry, 	INF 
 historia, 	NAV 
 acne, 	INF 
 historic, 	NAV 
 cub, 	INF 
 bethany, 	INF 
 corydon, 	INF 
 oliver, 	NAV 
 stroke, 	NAV 
 mustang, 	INF 
 puppies, 	NAV 
 nipples, 	NAV 
 jennifer, 	NAV 
 holey, 	NAV 
 shops, 	INF 
 millitary, 	NAV 
 biltmore, 	INF 
 ambria, 	INF 
 carry, 	NAV 
 tivo, 	INF 
 preseasoned, 	INF 
 wild, 	INF 
 maudlin, 	NAV 
 mothers, 	INF 
 jordan, 	NAV 
 kinderhook, 	NAV 
 regarding, 	INF 
 fishkill, 	NAV 
 strawberry, 	INF 
 distribution, 	INF 
 busta, 	NAV 
 tara, 	INF 
 3000, 	INF 
 shoot, 	INF 
 jesus, 	NAV 
 remington, 	NAV 
 will, 	RES 
 auto, 	NAV 
 virtual, 	NAV 
 shore, 	NAV 
 getting, 	NAV 
 home, 	NAV 
 egyptian, 	NAV 
 empire, 	INF 
 partum, 	NAV 
 patricks, 	INF 
 tape, 	NAV 
 alienwear, 	INF 
 savings, 	INF 
 polls, 	NAV 
 coogan, 	INF 
 quit, 	NAV 
 short, 	INF 
 thank, 	INF 
 pokemon, 	INF 
 capellini's, 	INF 
 guiding, 	NAV 
 greensboro, 	INF 
 depot, 	INF 
 antonio, 	NAV 
 namad, 	INF 
 portion, 	INF 
 lexus, 	NAV 
 diversity, 	INF 
 articles, 	INF 
 20lapel, 	NAV 
 greek, 	NAV 
 green, 	NAV 
 acme, 	INF 
 cambrian, 	NAV 
 viejas, 	INF 
 master, 	INF 
 despues, 	NAV 
 vegan, 	NAV 
 artisans, 	INF 
 hollow, 	INF 
 ovarian, 	NAV 
 gingras, 	INF 
 25th, 	NAV 
 tits, 	INF 
 vegas, 	NAV 
 closing, 	NAV 
 nylon, 	NAV 
 yacht, 	INF 
 dragon, 	NAV 
 ranger, 	NAV 
 staten, 	INF 
 stockton, 	NAV 
 schools, 	NAV 
 foreman, 	NAV 
 family, 	NAV 
 howard, 	NAV 
 interviewing, 	NAV 
 miller, 	NAV 
 lidia, 	NAV 
 cheerleading, 	INF 
 forster, 	INF 
 viagra, 	NAV 
 rainforest, 	INF 
 cooper, 	INF 
 clubs, 	NAV 
 strasburg, 	INF 
 munoz, 	NAV 
 winter, 	INF 
 hyatt, 	INF 
 lives, 	NAV 
 liver, 	NAV 
 streets, 	INF 
 batman, 	INF 
 kikuyu, 	NAV 
 fulton, 	NAV 
 glaucoma, 	NAV 
 trailer, 	INF 
 muvico, 	INF 
 horses, 	INF 
 laconia, 	NAV 
 downloadable, 	INF 
 akita, 	INF 
 wilson, 	INF 
 mom's, 	NAV 
 building, 	INF 
 750, 	NAV 
 registration, 	INF 
 drury, 	NAV 
 tips, 	NAV 
 salinas, 	NAV 
 bastianich's, 	NAV 
 minsk, 	INF 
 hearts, 	NAV 
 dobbs, 	NAV 
 equipment, 	NAV 
 cope, 	INF 
 yellow, 	INF 
 tylenol, 	NAV 
 maynard, 	NAV 
 macys, 	NAV 
 hairy, 	NAV 
 wmiddletown, 	NAV 
 seat, 	INF 
 interest, 	INF 
 cle, 	INF 
 ipod, 	NAV 
 pelvic, 	INF 
 hunt, 	INF 
 commission, 	NAV 
 supplies, 	INF 
 copy, 	INF 
 cool, 	INF 
 cook, 	NAV 
 rosario, 	INF 
 drafting, 	NAV 
 variables, 	INF 
 models, 	INF 
 oympia, 	INF 
 seagrass, 	INF 
 los, 	NAV 
 lou, 	INF 
 pantogram, 	INF 
 mcmillan, 	INF 
 low, 	NAV 
 examples, 	NAV 
 eyed, 	INF 
 acts, 	NAV 
 i've, 	NAV 
 willowbrook, 	INF 
 archives, 	INF 
 advertising, 	NAV 
 use, 	NAV 
 states, 	NAV 
 rochelle, 	INF 
 usa, 	INF 
 babe, 	INF 
 familiesof, 	INF 
 kingdom, 	NAV 
 arizona, 	INF 
 cna, 	NAV 
 suits, 	INF 
 uss, 	INF 
 baby, 	NAV 
 healing, 	INF 
 license, 	NAV 
 usp, 	NAV 
 tubes, 	NAV 
 preschool, 	INF 
 cons, 	INF 
 comp, 	NAV 
 limousine, 	INF 
 designer, 	INF 
 back, 	NAV 
 pennsylvania, 	INF 
 margaret, 	NAV 
 seek, 	NAV 
 dunlop, 	INF 
 talking, 	NAV 
 stanice, 	INF 
 cod, 	INF 
 practice, 	NAV 
 fairbanks, 	NAV 
 original, 	NAV 
 south, 	NAV 
 torre, 	INF 
 nissan, 	NAV 
 con, 	NAV 
 24th, 	NAV 
 com, 	NAV 
 follicular, 	NAV 
 sports, 	INF 
 lts, 	NAV 
 arthrotec, 	INF 
 download, 	INF 
 boggs, 	INF 
 dividing, 	INF 
 cox, 	INF 
 science, 	NAV 
 frontier, 	INF 
 undertaker, 	INF 
 robin, 	INF 
 camcorder, 	INF 
 orlando, 	NAV 
 divorce, 	INF 
 lunch, 	NAV 
 chicago, 	INF 
 replica, 	INF 
 75th, 	INF 
 cpr, 	INF 
 headlight, 	NAV 
 period, 	NAV 
 recruiter's, 	INF 
 pubic, 	NAV 
 shields, 	NAV 
 sweet, 	NAV 
 battle, 	INF 
 flemings, 	NAV 
 passionup, 	INF 
 osmo, 	INF 
 covercraft, 	INF 
 decorations, 	INF 
 grenade, 	NAV 
 mythical, 	NAV 
 english, 	NAV 
 australian, 	INF 
 presbyterian, 	INF 
 henri, 	NAV 
 iatse, 	NAV 
 dental, 	INF 
 childrens, 	INF 
 murrells, 	NAV 
 hurricane, 	NAV 
 realtor, 	NAV 
 setting, 	INF 
 holmes, 	NAV 
 federal, 	NAV 
 riverside, 	INF 
 cory, 	INF 
 federation, 	NAV 
 henry, 	NAV 
 citibank, 	INF 
 fabric, 	NAV 
 seiu, 	INF 
 non-toxic, 	NAV 
 sg-1, 	INF 
 cabinet, 	NAV 
 banging, 	NAV 
 cry, 	INF 
 expecting, 	NAV 
 julie, 	NAV 
 unit, 	INF 
 feingold, 	INF 
 regional, 	INF 
 registered, 	INF 
 2003;harley-davidson, 	INF 
 panini, 	INF 
 upn, 	INF 
 cord, 	INF 
 ups, 	INF 
 bacillus, 	INF 
 csi, 	INF 
 monkey, 	NAV 
 pittsburg, 	NAV 
 person, 	INF 
 congregation, 	INF 
 tugboat, 	INF 
 brokerage, 	INF 
 house, 	NAV 
 avoid, 	NAV 
 blazer, 	INF 
 tree, 	NAV 
 martini, 	NAV 
 income, 	INF 
 casting, 	INF 
 pour, 	INF 
 inexpensive, 	NAV 
 hewlett, 	NAV 
 nights, 	NAV 
 cirque, 	INF 
 regal, 	INF 
 blame, 	NAV 
 silvercrest, 	INF 
 drugs, 	NAV 
 parlamento, 	INF 
 middleburg, 	INF 
 tomatoes, 	NAV 
 trek, 	INF 
 bait, 	INF 
 cdi, 	INF 
 funeral, 	NAV 
 pomperaug, 	INF 
 auditions, 	INF 
 komen, 	NAV 
 glove, 	NAV 
 port, 	INF 
 prayer, 	INF 
 blushing, 	INF 
 secure, 	NAV 
 cultural, 	NAV 
 apartment, 	NAV 
 self, 	NAV 
 lyrics, 	NAV 
 modern, 	NAV 
 48th, 	INF 
 sell, 	NAV 
 ball, 	NAV 
 impingement, 	INF 
 anthony, 	INF 
 blank, 	INF 
 post, 	NAV 
 cases, 	INF 
 resorts, 	NAV 
 characteristics, 	NAV 
 leo, 	NAV 
 carroll, 	INF 
 bald, 	NAV 
 nacho, 	NAV 
 chrysler, 	INF 
 w.c, 	INF 
 lee, 	NAV 
 transgenic, 	NAV 
 led, 	INF 
 lea, 	INF 
 kane, 	NAV 
 radio, 	INF 
 broadband, 	INF 
 stores, 	NAV 
 cody, 	INF 
 phone, 	NAV 
 growers, 	NAV 
 alan, 	INF 
 jumpsuit, 	NAV 
 mother's, 	NAV 
 mccormick, 	NAV 
 pops, 	NAV 
 specialized, 	INF 
 priced, 	INF 
 beaches, 	NAV 
 cola, 	INF 
 vikings, 	NAV 
 cold, 	NAV 
 nurse, 	NAV 
 remedies, 	NAV 
 18th, 	NAV 
 consulate, 	NAV 
 certified, 	INF 
 greeting, 	INF 
 herald, 	NAV 
 indianapolis, 	NAV 
 selmer, 	INF 
 literature, 	INF 
 henderson, 	INF 
 store-, 	INF 
 junior, 	NAV 
 greenville, 	NAV 
 formal, 	NAV 
 statue, 	NAV 
 coke, 	NAV 
 season, 	INF 
 porn, 	INF 
 nilla, 	NAV 
 chi, 	INF 
 midget, 	NAV 
 tradesman, 	INF 
 match, 	NAV 
 suite, 	INF 
 athletic, 	INF 
 contrasting, 	INF 
 highest, 	NAV 
 evolutionx, 	INF 
 convert, 	INF 
 microsoft, 	INF 
 yuma, 	INF 
 pooh, 	INF 
 pool, 	INF 
 vali-hi, 	INF 
 knuckle, 	NAV 
 uncc, 	NAV 
 cameras, 	INF 
 olivos, 	NAV 
 r402jw, 	INF 
 abnormal, 	INF 
 starwoods, 	INF 
 pipes, 	INF 
 piper, 	INF 
 orleans, 	NAV 
 mojave, 	NAV 
 municipal, 	INF 
 prices, 	NAV 
 lil, 	NAV 
 trainers, 	INF 
 kaiser, 	NAV 
 first, 	NAV 
 priscill, 	INF 
 communities, 	INF 
 lawn, 	NAV 
 washburn, 	INF 
 bookstore, 	INF 
 airlines, 	NAV 
 ecurity, 	NAV 
 laws, 	NAV 
 westgate, 	INF 
 rockford, 	INF 
 hedda, 	NAV 
 effects, 	INF 
 universe, 	NAV 
 solano, 	NAV 
 senator, 	INF 
 review, 	NAV 
 hospital, 	NAV 
 introduction, 	INF 
 centenial, 	INF 
 austin, 	INF 
 iraqi, 	NAV 
 wisconsin, 	INF 
 nude, 	NAV 
 anderson, 	INF 
 hartford, 	NAV 
 ureteral, 	INF 
 measuring, 	NAV 
 chelsea, 	INF 
 surrogates, 	INF 
 write, 	NAV 
 map, 	NAV 
 portage, 	INF 
 knickerbocker, 	NAV 
 evening, 	NAV 
 man, 	NAV 
 may, 	NAV 
 ministries, 	INF 
 lincoln, 	NAV 
 max, 	NAV 
 louisiana, 	NAV 
 wearing, 	INF 
 mba, 	NAV 
 volcom, 	INF 
 bill's, 	INF 
 memphis, 	NAV 
 starts, 	INF 
 allied, 	INF 
 what, 	NAV 
 dining, 	NAV 
 naturino, 	NAV 
 dade, 	NAV 
 wolfe, 	INF 
 studio, 	INF 
 horton, 	NAV 
 antoinette, 	INF 
 award, 	INF 
 carmans, 	INF 
 citronella, 	INF 
 crappie, 	INF 
 balance, 	INF 
 ncaa, 	NAV 
 future, 	NAV 
 realty, 	INF 
 cement, 	NAV 
 arlen, 	INF 
 azure, 	INF 
 financial, 	INF 
 nascar, 	NAV 
 bishop, 	NAV 
 neisd, 	INF 
 eeo, 	NAV 
 begins, 	INF 
 stress, 	INF 
 canwel, 	INF 
 1950's, 	INF 
 australia, 	INF 
 cornbread, 	NAV 
 deborah, 	INF 
 internet, 	NAV 
 mu??ecas, 	NAV 
 mobile, 	INF 
 med, 	NAV 
 calebs, 	INF 
 clothing, 	INF 
 railroad, 	INF 
 collier, 	INF 
 chosen, 	INF 
 island, 	NAV 
 broward, 	INF 
 amelia, 	INF 
 elkhart, 	NAV 
 brevard, 	INF 
 swim, 	INF 
 mel, 	NAV 
 men, 	NAV 
 trim, 	NAV 
 phoenix, 	INF 
 cnbc, 	INF 
 gleneagle, 	NAV 
 danbury, 	NAV 
 elbow, 	NAV 
 emotional, 	NAV 
 tires, 	INF 
 daniel, 	INF 
 employment, 	NAV 
 automobile, 	INF 
 enrichment, 	NAV 
 street, 	NAV 
 determine, 	INF 
 pawns, 	NAV 
 heritage, 	NAV 
 peregrin, 	INF 
 impairment, 	INF 
 villa, 	NAV 
 spiritual, 	NAV 
 ciber, 	NAV 
 laser, 	NAV 
 wolly, 	INF 
 pleasant, 	INF 
 walmart, 	NAV 
 cherokee, 	INF 
 iowa, 	NAV 
 animals, 	NAV 
 gene, 	INF 
 theorem, 	NAV 
 richmond, 	INF 
 knoxville, 	NAV 
 petit, 	INF 
 monthly, 	NAV 
 farrakhan, 	NAV 
 dowload, 	NAV 
 kathleen, 	NAV 
 flea, 	INF 
 porcelain, 	NAV 
 county, 	NAV 
 ebony, 	NAV 
 collins, 	NAV 
 evaluate, 	NAV 
 breeze, 	INF 
 fashion, 	NAV 
 development, 	NAV 
 sportys, 	INF 
 rapper, 	INF 
 odessa, 	INF 
 dinars, 	NAV 
 compaq, 	INF 
 restaurants-, 	INF 
 cardinals, 	INF 
 phillips-robinson, 	NAV 
 chicken, 	NAV 
 massage, 	NAV 
 mathews, 	INF 
 broadleaf, 	INF 
 cosmos, 	INF 
 internal, 	NAV 
 ramada, 	INF 
 banner, 	NAV 
 lion, 	INF 
 books-, 	INF 
 british, 	NAV 
 dvd, 	NAV 
 pages, 	INF 
 true, 	NAV 
 marriage, 	INF 
 hawthorne, 	NAV 
 newyork, 	INF 
 parchem, 	INF 
 fremont, 	INF 
 herbal, 	NAV 
 soapstone, 	INF 
 kansas, 	NAV 
 last, 	NAV 
 individual, 	INF 
 sometimes, 	NAV 
 fraud, 	NAV 
 military, 	NAV 
 kalamazoo, 	INF 
 directions, 	NAV 
 fucking, 	NAV 
 rashes, 	INF 
 bayonne, 	INF 
 poems, 	NAV 
 lyn, 	NAV 
 homes, 	NAV 
 credit, 	NAV 
 live, 	NAV 
 peter, 	NAV 
 chantilly, 	INF 
 hummel, 	NAV 
 flag, 	INF 
 permanent, 	INF 
 chiense, 	INF 
 eastern, 	INF 
 hummer, 	INF 
 forearm, 	NAV 
 jammies, 	NAV 
 jack, 	NAV 
 tickle, 	NAV 
 highway, 	NAV 
 fitness, 	INF 
 elephant, 	NAV 
 volunteer, 	INF 
 sleeping, 	NAV 
 alabama, 	NAV 
 colton, 	INF 
 throwing, 	NAV 
 father, 	NAV 
 santa, 	NAV 
 zepplin, 	INF 
 layout, 	NAV 
 lite, 	INF 
 sexual, 	INF 
 lining, 	INF 
 silver, 	INF 
 voyeur, 	INF 
 list, 	NAV 
 starship, 	INF 
 section, 	INF 
 suites, 	NAV 
 human, 	NAV 
 townsend, 	INF 
 panama, 	NAV 
 taggie, 	INF 
 twp, 	INF 
 two, 	INF 
 easter, 	NAV 
 rating, 	INF 
 hotel, 	NAV 
 mathers, 	NAV 
 summary, 	INF 
 dom, 	NAV 
 corners, 	NAV 
 retardation, 	INF 
 mr2, 	NAV 
 stanislaus, 	INF 
 dot, 	NAV 
 1970, 	INF 
 assistant, 	INF 
 nature, 	INF 
 baseball, 	NAV 
 napolean, 	NAV 
 1978, 	INF 
 northeastern, 	INF 
 signature, 	NAV 
 childern, 	NAV 
 books, 	INF 
 going, 	NAV 
 tsar, 	NAV 
 cell, 	NAV 
 matthew, 	NAV 
 compost, 	INF 
 windows, 	NAV 
 mom, 	NAV 
 tri, 	NAV 
 floor, 	NAV 
 1984, 	INF 
 pajaronian, 	INF 
 1988, 	INF 
 exam, 	NAV 
 ruger, 	INF 
 frank, 	NAV 
 multi-unit, 	INF 
 holly, 	NAV 
 mt., 	INF 
 simple, 	INF 
 chrome, 	INF 
 akron, 	NAV 
 collection, 	INF 
 date, 	INF 
 spring, 	NAV 
 dmv, 	NAV 
 printable, 	NAV 
 1996, 	INF 
 1997, 	NAV 
 leads, 	NAV 
 charleston, 	NAV 
 risen, 	INF 
 1991, 	INF 
 1994, 	INF 
 petco, 	INF 
 sprint, 	INF 
 1999, 	INF 
 msc, 	NAV 
 extremely, 	NAV 
 obadiah, 	NAV 
 carnival, 	INF 
 s-corporation, 	INF 
 haflinger, 	INF 
 wallace, 	INF 
 hinckley, 	NAV 
 brad, 	NAV 
 jessica, 	NAV 
 boone, 	INF 
 instituto, 	INF 
 edward, 	NAV 
 dog, 	NAV 
 infrastructure, 	NAV 
 stargate, 	INF 
 kenneth, 	NAV 
 harry, 	NAV 
 portable, 	NAV 
 irish, 	NAV 
 framingham, 	INF 
 plantation, 	NAV 
 bloomfield, 	INF 
 realtors, 	INF 
 venetian, 	INF 
 atkins, 	INF 
 questionnaire, 	NAV 
 platte, 	NAV 
 student, 	NAV 
 dark, 	INF 
 inlet, 	NAV 
 toothpicks, 	INF 
 collecting, 	NAV 
 lake, 	NAV 
 kids, 	NAV 
 listings, 	NAV 
 logic, 	INF 
 wanderer's, 	INF 
 alene, 	INF 
 frame, 	INF 
 dui, 	NAV 
 everhot, 	NAV 
 due, 	NAV 
 paddle, 	INF 
 liquor, 	NAV 
 penn, 	INF 
 weight, 	NAV 
 rocky, 	INF 
 land, 	NAV 
 jackson's, 	NAV 
 turtle, 	INF 
 elliptical, 	NAV 
 lane, 	NAV 
 cacner, 	INF 
 toy, 	INF 
 roslyn, 	INF 
 starusa, 	NAV 
 tow, 	INF 
 tom, 	NAV 
 ivory, 	NAV 
 dispatch, 	INF 
 top, 	INF 
 muscle, 	NAV 
 veradale, 	INF 
 wonders, 	INF 
 dsl, 	NAV 
 krussell, 	NAV 
 lamp, 	NAV 
 intel, 	INF 
 serial, 	NAV 
 poseidon, 	INF 
 dane, 	NAV 
 poultry, 	NAV 
 dana, 	INF 
 escambia, 	NAV 
 rescue, 	INF 
 shine, 	NAV 
 technical, 	NAV 
 tin, 	NAV 
 tim, 	NAV 
 tip, 	INF 
 alpine, 	INF 
 center, 	NAV 
 danza, 	INF 
 pruning, 	NAV 
 tic, 	NAV 
 windowsmedia, 	INF 
 armed, 	INF 
 flower, 	NAV 
 dame, 	INF 
 did, 	NAV 
 delaware, 	INF 
 bargain, 	INF 
 without, 	RES 
 concrete, 	INF 
 record, 	NAV 
 stafford, 	INF 
 canadian, 	INF 
 david, 	NAV 
 davie, 	INF 
 cross, 	INF 
 reaction, 	INF 
 kink, 	INF 
 audi, 	INF 
 des, 	INF 
 bariatric, 	NAV 
 islamic, 	NAV 
 dale, 	INF 
 schoolboy, 	NAV 
 umbra, 	INF 
 kodak, 	INF 
 1915, 	INF 
 tumors, 	INF 
 king, 	NAV 
 multiroom, 	NAV 
 private, 	INF 
 klein, 	INF 
 thurmount, 	NAV 
 bike, 	NAV 
 funtime, 	INF 
 larry, 	NAV 
 booty, 	INF 
 jaspers, 	NAV 
 kokanee, 	NAV 
 diebold, 	INF 
 acids, 	INF 
 murray, 	NAV 
 speaker, 	INF 
 shelly, 	INF 
 slip, 	INF 
 christmas, 	INF 
 dictionary, 	INF 
 research, 	NAV 
 mix, 	NAV 
 obtaining, 	NAV 
 collagen, 	NAV 
 subaru, 	NAV 
 spirit, 	NAV 
 mid, 	NAV 
 bric, 	INF 
 tabs, 	NAV 
 ten, 	NAV 
 spartan, 	INF 
 1935, 	INF 
 dld, 	NAV 
 frankin, 	NAV 
 tee, 	NAV 
 mls, 	NAV 
 kill, 	INF 
 ted, 	NAV 
 cannon, 	NAV 
 supra, 	NAV 
 radiology, 	NAV 
 mn., 	INF 
 stabler, 	INF 
 martin, 	NAV 
 woman, 	NAV 
 taco, 	NAV 
 shephards, 	INF 
 power, 	INF 
 repair, 	INF 
 mlb, 	NAV 
 circleville, 	NAV 
 symbol, 	INF 
 infantry, 	NAV 
 steelworkers, 	INF 
 market, 	NAV 
 1040, 	NAV 
 gainesville, 	NAV 
 epps, 	NAV 
 suffolk, 	INF 
 nsaids, 	NAV 
 filter, 	INF 
 grossman, 	INF 
 other, 	INF 
 davis, 	INF 
 jewish, 	NAV 
 tgp, 	INF 
 crown, 	NAV 
 cherche, 	INF 
 magicolor, 	NAV 
 diy, 	NAV 
 kentucky, 	NAV 
 miniature, 	INF 
 share, 	INF 
 parameter, 	INF 
 order, 	NAV 
 chambers, 	INF 
 batting, 	INF 
 mexico's, 	NAV 
 espa??ol, 	INF 
 jelly, 	INF 
 nikka, 	INF 
 sabres, 	INF 
 campbell, 	INF 
 justin, 	NAV 
 sharp, 	INF 
 carthage, 	INF 
 1967, 	INF 
 aurora, 	NAV 
 keyport, 	NAV 
 shark, 	INF 
 the, 	NAV 
 women, 	NAV 
 kiki, 	INF 
 1960, 	INF 
 bronze, 	INF 
 bissell, 	INF 
 beaver, 	INF 
 lady, 	NAV 
 summer, 	NAV 
 truimph, 	INF 
 iceman, 	NAV 
